{
"x": 2,
"y": -42,
"biomeType": "DESERT",
"tileData": [
	[ 1, 1, 1, 15, 15, 15, 15, 15, 15, 15, 15, 16, 15, 15, 15, 15 ],
	[ 10, 1, 2, 15, 17, 15, 15, 15, 2, 15, 17, 15, 15, 2, 15, 2 ],
	[ 10, 16, 16, 15, 15, 15, 15, 2, 15, 16, 17, 15, 15, 16, 15, 15 ],
	[ 17, 17, 15, 15, 15, 16, 15, 2, 16, 17, 15, 15, 15, 15, 2, 15 ],
	[ 15, 15, 15, 15, 15, 17, 15, 15, 17, 15, 2, 15, 15, 15, 15, 15 ],
	[ 15, 15, 15, 15, 17, 15, 15, 15, 15, 15, 15, 15, 15, 15, 15, 15 ],
	[ 15, 2, 2, 15, 15, 17, 2, 15, 15, 15, 2, 15, 17, 17, 15, 15 ],
	[ 2, 15, 2, 15, 15, 17, 15, 2, 15, 17, 15, 15, 15, 15, 15, 17 ],
	[ 15, 2, 15, 15, 17, 15, 2, 17, 15, 15, 15, 15, 15, 2, 15, 15 ],
	[ 15, 15, 15, 15, 15, 15, 2, 17, 15, 17, 2, 15, 15, 16, 15, 15 ],
	[ 15, 15, 15, 15, 15, 16, 15, 15, 15, 15, 15, 15, 16, 16, 2, 15 ],
	[ 2, 15, 15, 15, 15, 15, 15, 16, 15, 15, 2, 15, 15, 16, 15, 15 ],
	[ 15, 15, 15, 17, 15, 15, 15, 15, 15, 15, 15, 2, 17, 15, 15, 15 ],
	[ 15, 2, 15, 16, 2, 15, 17, 15, 2, 2, 15, 2, 16, 2, 15, 15 ],
	[ 15, 15, 16, 15, 15, 15, 15, 2, 16, 2, 15, 16, 17, 15, 2, 15 ],
	[ 15, 15, 17, 16, 15, 15, 15, 15, 15, 16, 2, 2, 15, 15, 15, 17 ]
],
"objects": [
	{
		"class": "io.github.pokemeetup.system.gameplay.overworld.World$WorldObjectData",
		"x": 1056,
		"y": -21472,
		"type": "POKEBALL"
	}
],
"blocks": [],
"lastModified": 0,
"isMultiplayer": false
}