{
"x": 6,
"y": -6,
"biomeType": "DESERT",
"tileData": [
	[ 1, 1, 17, 15, 2, 17, 2, 15, 15, 2, 16, 15, 17, 15, 15, 15 ],
	[ 10, 15, 2, 2, 2, 15, 15, 15, 15, 15, 15, 15, 15, 15, 15, 15 ],
	[ 15, 15, 15, 15, 2, 15, 15, 15, 2, 17, 15, 2, 15, 15, 2, 15 ],
	[ 15, 17, 16, 15, 15, 15, 15, 15, 15, 16, 15, 15, 15, 15, 15, 17 ],
	[ 15, 15, 2, 15, 2, 2, 15, 15, 15, 15, 15, 15, 15, 15, 15, 16 ],
	[ 15, 15, 15, 15, 15, 15, 15, 16, 2, 15, 15, 15, 15, 16, 15, 2 ],
	[ 15, 15, 15, 16, 15, 15, 16, 15, 15, 15, 15, 15, 15, 17, 2, 15 ],
	[ 15, 15, 15, 15, 15, 16, 2, 15, 15, 15, 15, 17, 17, 15, 15, 15 ],
	[ 15, 2, 2, 2, 15, 15, 15, 2, 2, 15, 15, 15, 2, 15, 15, 15 ],
	[ 15, 15, 15, 15, 15, 15, 15, 15, 15, 2, 2, 2, 15, 15, 15, 15 ],
	[ 15, 15, 15, 15, 15, 15, 16, 15, 15, 15, 2, 15, 2, 15, 16, 17 ],
	[ 16, 16, 15, 15, 17, 15, 17, 15, 16, 15, 15, 2, 15, 17, 17, 15 ],
	[ 15, 15, 15, 15, 2, 15, 15, 15, 15, 15, 15, 15, 15, 15, 15, 2 ],
	[ 15, 15, 15, 15, 15, 15, 15, 15, 15, 17, 15, 2, 2, 16, 15, 15 ],
	[ 15, 2, 15, 15, 15, 15, 15, 15, 15, 2, 17, 2, 15, 15, 15, 2 ],
	[ 17, 15, 17, 17, 15, 15, 15, 2, 2, 15, 2, 16, 15, 15, 17, 2 ]
],
"objects": [
	{
		"class": "io.github.pokemeetup.system.gameplay.overworld.World$WorldObjectData",
		"x": 3200,
		"y": -3008,
		"type": "POKEBALL"
	}
],
"blocks": [],
"lastModified": 0,
"isMultiplayer": false
}