{
"x": -17,
"y": -83,
"biomeType": "PLAINS",
"tileData": [
	[ 55, 56, 1, 56, 1, 56, 1, 24, 1, 24, 1, 1, 1, 10, 1, 24 ],
	[ 56, 56, 56, 56, 56, 10, 10, 10, 1, 23, 1, 10, 10, 24, 10, 1 ],
	[ 53, 56, 56, 10, 1, 10, 10, 10, 10, 1, 1, 1, 10, 1, 1, 10 ],
	[ 1, 10, 1, 1, 10, 1, 1, 10, 10, 10, 1, 22, 1, 10, 1, 10 ],
	[ 10, 1, 10, 10, 1, 23, 24, 1, 1, 1, 10, 1, 24, 10, 1, 1 ],
	[ 1, 10, 10, 1, 1, 10, 1, 1, 10, 1, 1, 1, 24, 1, 1, 1 ],
	[ 10, 10, 22, 24, 1, 1, 1, 10, 10, 1, 1, 1, 10, 1, 1, 10 ],
	[ 1, 1, 24, 10, 10, 1, 1, 10, 1, 24, 1, 10, 10, 1, 1, 24 ],
	[ 1, 1, 10, 1, 1, 1, 1, 10, 10, 10, 1, 1, 10, 1, 1, 10 ],
	[ 1, 10, 10, 1, 1, 22, 10, 1, 24, 10, 1, 1, 10, 1, 24, 10 ],
	[ 10, 10, 1, 1, 1, 10, 1, 24, 10, 1, 1, 1, 1, 1, 1, 1 ],
	[ 1, 1, 1, 10, 10, 10, 1, 10, 1, 10, 22, 10, 10, 24, 10, 1 ],
	[ 1, 1, 10, 10, 1, 24, 1, 1, 10, 24, 10, 1, 10, 1, 10, 1 ],
	[ 10, 10, 10, 1, 10, 1, 1, 1, 10, 1, 24, 1, 10, 1, 1, 10 ],
	[ 1, 1, 10, 10, 1, 10, 1, 1, 10, 1, 10, 1, 1, 10, 10, 1 ],
	[ 1, 10, 10, 1, 1, 10, 10, 1, 10, 1, 10, 1, 1, 24, 10, 23 ]
],
"objects": [
	{
		"class": "io.github.pokemeetup.system.gameplay.overworld.World$WorldObjectData",
		"x": -8640,
		"y": -42464,
		"type": "RUINS_TREE"
	},
	{
		"class": "io.github.pokemeetup.system.gameplay.overworld.World$WorldObjectData",
		"x": -8608,
		"y": -42176,
		"type": "POKEBALL"
	}
],
"blocks": [],
"lastModified": 0,
"isMultiplayer": false
}