{
"x": -18,
"y": -84,
"biomeType": "RUINS",
"tileData": [
	[ 10, 1, 56, 56, 1, 56, 56, 56, 56, 56, 54, 56, 56, 53, 53, 56 ],
	[ 53, 56, 10, 56, 56, 54, 54, 56, 56, 56, 55, 56, 54, 55, 54, 56 ],
	[ 56, 56, 56, 53, 56, 56, 56, 53, 56, 56, 54, 56, 56, 56, 56, 56 ],
	[ 10, 1, 56, 56, 54, 56, 56, 56, 56, 56, 56, 54, 56, 56, 56, 55 ],
	[ 56, 56, 55, 56, 56, 56, 56, 56, 56, 54, 56, 56, 56, 56, 53, 53 ],
	[ 10, 56, 56, 56, 56, 56, 56, 54, 56, 55, 56, 56, 56, 56, 56, 54 ],
	[ 53, 56, 56, 56, 53, 56, 53, 56, 54, 56, 56, 53, 55, 55, 55, 56 ],
	[ 56, 56, 56, 54, 55, 55, 56, 54, 56, 56, 53, 56, 56, 53, 56, 56 ],
	[ 55, 53, 56, 55, 56, 56, 56, 54, 56, 56, 55, 56, 56, 56, 54, 56 ],
	[ 53, 53, 56, 56, 56, 56, 56, 56, 54, 53, 56, 56, 56, 56, 56, 56 ],
	[ 55, 56, 56, 55, 55, 54, 56, 56, 56, 54, 56, 56, 56, 53, 56, 56 ],
	[ 53, 56, 56, 56, 53, 56, 56, 56, 56, 56, 56, 54, 56, 56, 56, 55 ],
	[ 56, 54, 56, 55, 56, 56, 56, 56, 55, 56, 53, 56, 53, 56, 54, 54 ],
	[ 53, 56, 54, 53, 54, 56, 56, 54, 55, 53, 56, 53, 56, 56, 56, 56 ],
	[ 56, 56, 56, 53, 55, 56, 56, 55, 56, 53, 54, 56, 55, 54, 56, 54 ],
	[ 56, 56, 56, 56, 56, 56, 56, 56, 56, 56, 56, 54, 56, 56, 56, 56 ]
],
"objects": [
	{
		"class": "io.github.pokemeetup.system.gameplay.overworld.World$WorldObjectData",
		"x": -9216,
		"y": -42880,
		"type": "POKEBALL"
	}
],
"blocks": [],
"lastModified": 0,
"isMultiplayer": false
}