{
"x": 3,
"y": -41,
"biomeType": "HAUNTED",
"tileData": [
	[ 15, 15, 15, 15, 16, 15, 23, 10, 1, 10, 1, 1, 24, 1, 1, 1 ],
	[ 15, 15, 15, 16, 15, 15, 10, 1, 1, 1, 1, 24, 1, 24, 10, 1 ],
	[ 5, 5, 8, 1, 5, 7, 5, 5, 5, 7, 10, 10, 24, 1, 10, 1 ],
	[ 5, 5, 7, 5, 7, 5, 5, 5, 7, 9, 5, 5, 5, 5, 10, 24 ],
	[ 5, 7, 5, 7, 5, 5, 9, 5, 5, 9, 5, 9, 5, 7, 8, 5 ],
	[ 5, 7, 8, 7, 5, 5, 5, 5, 5, 9, 7, 5, 5, 5, 9, 8 ],
	[ 5, 8, 5, 5, 5, 5, 9, 7, 5, 7, 5, 5, 5, 5, 5, 7 ],
	[ 9, 5, 5, 5, 7, 5, 7, 5, 9, 5, 9, 5, 5, 5, 7, 5 ],
	[ 5, 5, 9, 5, 5, 5, 7, 7, 5, 7, 7, 7, 7, 1, 7, 8 ],
	[ 5, 5, 7, 5, 5, 9, 9, 5, 5, 5, 5, 7, 7, 7, 5, 7 ],
	[ 8, 7, 5, 5, 1, 7, 5, 5, 5, 5, 7, 7, 7, 5, 5, 7 ],
	[ 5, 5, 5, 7, 7, 5, 9, 8, 5, 5, 5, 7, 5, 5, 7, 10 ],
	[ 5, 9, 8, 7, 5, 5, 8, 7, 7, 7, 7, 7, 5, 7, 7, 1 ],
	[ 7, 7, 5, 5, 9, 7, 5, 5, 7, 5, 5, 9, 8, 9, 5, 7 ],
	[ 5, 5, 5, 5, 7, 7, 5, 7, 5, 5, 5, 8, 5, 5, 7, 5 ],
	[ 9, 5, 7, 5, 7, 10, 5, 5, 5, 7, 7, 5, 7, 5, 5, 5 ]
],
"objects": [
	{
		"class": "io.github.pokemeetup.system.gameplay.overworld.World$WorldObjectData",
		"x": 1568,
		"y": -20736,
		"type": "POKEBALL"
	}
],
"blocks": [],
"lastModified": 0,
"isMultiplayer": false
}