{
"x": -25,
"y": -84,
"biomeType": "RUINS",
"tileData": [
	[ 11, 11, 1, 56, 56, 56, 56, 56, 53, 56, 56, 56, 53, 56, 56, 56 ],
	[ 10, 12, 11, 56, 56, 56, 56, 56, 56, 56, 56, 56, 56, 56, 56, 53 ],
	[ 11, 11, 12, 11, 53, 56, 56, 56, 56, 56, 56, 56, 56, 56, 54, 56 ],
	[ 11, 12, 54, 56, 56, 56, 56, 56, 55, 55, 56, 56, 56, 53, 56, 53 ],
	[ 11, 1, 56, 11, 55, 53, 56, 56, 56, 54, 55, 54, 53, 56, 54, 56 ],
	[ 1, 54, 55, 54, 56, 56, 56, 53, 56, 54, 56, 56, 56, 56, 56, 56 ],
	[ 12, 56, 55, 56, 56, 53, 56, 56, 53, 55, 54, 56, 56, 56, 56, 56 ],
	[ 1, 12, 54, 56, 56, 54, 54, 55, 55, 56, 56, 56, 56, 55, 56, 55 ],
	[ 1, 56, 56, 56, 56, 56, 56, 55, 54, 56, 54, 54, 55, 54, 56, 56 ],
	[ 11, 56, 56, 55, 53, 56, 55, 53, 56, 54, 55, 56, 54, 56, 54, 56 ],
	[ 11, 56, 54, 55, 55, 56, 53, 56, 56, 56, 56, 56, 56, 56, 56, 56 ],
	[ 1, 56, 53, 54, 56, 53, 56, 56, 55, 56, 53, 54, 56, 56, 54, 54 ],
	[ 10, 54, 54, 56, 54, 56, 56, 55, 55, 56, 56, 56, 56, 56, 56, 56 ],
	[ 11, 11, 56, 53, 56, 56, 55, 56, 56, 56, 56, 56, 56, 56, 56, 54 ],
	[ 1, 1, 12, 56, 54, 56, 54, 56, 53, 56, 56, 54, 56, 53, 54, 53 ],
	[ 11, 11, 11, 1, 56, 56, 56, 55, 56, 56, 54, 55, 54, 53, 56, 53 ]
],
"objects": [
	{
		"class": "io.github.pokemeetup.system.gameplay.overworld.World$WorldObjectData",
		"x": -12320,
		"y": -43008,
		"type": "TREE_0"
	},
	{
		"class": "io.github.pokemeetup.system.gameplay.overworld.World$WorldObjectData",
		"x": -12736,
		"y": -42976,
		"type": "TREE_0"
	},
	{
		"class": "io.github.pokemeetup.system.gameplay.overworld.World$WorldObjectData",
		"x": -12576,
		"y": -43008,
		"type": "POKEBALL"
	}
],
"blocks": [],
"lastModified": 0,
"isMultiplayer": false
}