{
"x": 10,
"y": -34,
"biomeType": "PLAINS",
"tileData": [
	[ 56, 1, 1, 22, 1, 24, 1, 10, 1, 10, 1, 1, 7, 5, 5, 5 ],
	[ 1, 56, 24, 10, 10, 1, 1, 1, 1, 24, 10, 8, 8, 5, 5, 5 ],
	[ 1, 53, 54, 1, 24, 1, 1, 1, 10, 1, 7, 1, 5, 8, 5, 5 ],
	[ 24, 1, 22, 10, 10, 1, 1, 1, 10, 5, 7, 5, 1, 9, 7, 5 ],
	[ 10, 24, 1, 1, 1, 10, 1, 22, 10, 1, 5, 5, 9, 1, 5, 5 ],
	[ 1, 1, 1, 1, 1, 24, 10, 10, 8, 1, 5, 5, 9, 8, 8, 5 ],
	[ 1, 1, 1, 10, 24, 24, 1, 5, 5, 1, 10, 7, 7, 7, 8, 5 ],
	[ 10, 1, 10, 10, 1, 10, 24, 5, 5, 1, 5, 7, 5, 7, 5, 5 ],
	[ 1, 1, 10, 10, 10, 10, 7, 5, 1, 8, 5, 9, 7, 7, 5, 5 ],
	[ 1, 24, 10, 1, 10, 1, 5, 5, 7, 5, 7, 7, 5, 5, 9, 8 ],
	[ 24, 1, 1, 1, 1, 5, 5, 10, 8, 5, 10, 7, 5, 5, 1, 5 ],
	[ 1, 24, 1, 1, 1, 5, 10, 22, 7, 5, 7, 5, 7, 7, 7, 7 ],
	[ 10, 22, 10, 10, 5, 8, 5, 1, 8, 5, 5, 5, 9, 5, 7, 7 ],
	[ 1, 10, 1, 1, 7, 10, 5, 1, 5, 5, 9, 9, 5, 7, 7, 5 ],
	[ 1, 1, 10, 10, 1, 5, 5, 5, 5, 7, 8, 5, 5, 5, 7, 5 ],
	[ 10, 10, 24, 1, 7, 7, 7, 5, 5, 1, 5, 7, 7, 5, 7, 8 ]
],
"objects": [
	{
		"class": "io.github.pokemeetup.system.gameplay.overworld.World$WorldObjectData",
		"x": 5184,
		"y": -17376,
		"type": "RUINS_TREE"
	},
	{
		"class": "io.github.pokemeetup.system.gameplay.overworld.World$WorldObjectData",
		"x": 5280,
		"y": -17280,
		"type": "POKEBALL"
	}
],
"blocks": [],
"lastModified": 0,
"isMultiplayer": false
}