{
"x": 5,
"y": -5,
"biomeType": "DESERT",
"tileData": [
	[ 1, 1, 10, 1, 15, 15, 2, 15, 15, 15, 17, 2, 15, 15, 15, 15 ],
	[ 10, 15, 1, 15, 2, 15, 15, 15, 16, 17, 15, 2, 2, 15, 15, 2 ],
	[ 1, 15, 2, 15, 15, 15, 17, 17, 15, 17, 2, 2, 15, 2, 17, 17 ],
	[ 16, 15, 15, 15, 15, 15, 15, 15, 15, 15, 2, 15, 15, 15, 15, 2 ],
	[ 16, 15, 17, 15, 2, 15, 2, 15, 15, 15, 15, 15, 16, 2, 15, 15 ],
	[ 15, 2, 15, 15, 17, 2, 15, 2, 17, 15, 15, 16, 2, 2, 15, 15 ],
	[ 15, 15, 15, 2, 15, 17, 15, 2, 15, 15, 2, 15, 15, 17, 15, 15 ],
	[ 15, 2, 17, 15, 15, 15, 15, 15, 2, 16, 15, 2, 2, 15, 15, 17 ],
	[ 15, 15, 16, 15, 15, 2, 15, 15, 2, 15, 2, 15, 15, 15, 15, 15 ],
	[ 17, 17, 15, 15, 15, 15, 15, 16, 15, 17, 15, 15, 15, 2, 15, 15 ],
	[ 15, 15, 2, 15, 15, 15, 16, 15, 15, 16, 2, 15, 15, 15, 2, 15 ],
	[ 15, 15, 2, 15, 2, 15, 15, 15, 15, 15, 15, 15, 17, 15, 15, 15 ],
	[ 2, 15, 15, 15, 15, 15, 17, 16, 2, 15, 15, 17, 15, 17, 15, 15 ],
	[ 17, 15, 15, 15, 15, 15, 15, 2, 15, 15, 15, 2, 15, 15, 2, 15 ],
	[ 15, 17, 15, 15, 2, 15, 2, 15, 17, 17, 15, 2, 16, 15, 15, 15 ],
	[ 15, 15, 15, 15, 15, 15, 15, 15, 15, 15, 15, 16, 15, 15, 15, 17 ]
],
"objects": [
	{
		"class": "io.github.pokemeetup.system.gameplay.overworld.World$WorldObjectData",
		"x": 2560,
		"y": -2464,
		"type": "APRICORN_TREE"
	},
	{
		"class": "io.github.pokemeetup.system.gameplay.overworld.World$WorldObjectData",
		"x": 2592,
		"y": -2176,
		"type": "POKEBALL"
	}
],
"blocks": [],
"lastModified": 0,
"isMultiplayer": false
}