{
"x": 9,
"y": -31,
"biomeType": "HAUNTED",
"tileData": [
	[ 1, 10, 1, 54, 1, 10, 10, 1, 10, 10, 10, 1, 10, 1, 24, 1 ],
	[ 56, 54, 1, 1, 10, 1, 24, 22, 1, 10, 1, 1, 1, 10, 1, 10 ],
	[ 1, 1, 1, 10, 10, 1, 10, 24, 10, 1, 10, 1, 23, 24, 24, 1 ],
	[ 1, 1, 10, 10, 5, 5, 7, 10, 5, 5, 1, 1, 7, 1, 5, 5 ],
	[ 10, 1, 10, 8, 5, 9, 5, 5, 5, 5, 1, 5, 24, 5, 7, 1 ],
	[ 24, 8, 7, 5, 1, 5, 5, 5, 5, 5, 5, 7, 5, 5, 5, 9 ],
	[ 1, 9, 9, 7, 5, 5, 5, 5, 5, 9, 1, 5, 5, 8, 9, 5 ],
	[ 5, 7, 7, 5, 7, 7, 9, 7, 1, 7, 5, 5, 5, 5, 7, 5 ],
	[ 7, 8, 5, 5, 5, 5, 5, 7, 7, 5, 5, 5, 7, 7, 7, 5 ],
	[ 5, 5, 5, 5, 9, 7, 5, 1, 5, 5, 5, 7, 1, 5, 8, 5 ],
	[ 5, 5, 5, 7, 9, 9, 9, 5, 5, 5, 5, 7, 5, 10, 5, 5 ],
	[ 5, 9, 7, 5, 5, 8, 5, 5, 7, 5, 7, 5, 5, 5, 5, 5 ],
	[ 1, 8, 5, 7, 7, 7, 5, 1, 9, 8, 8, 1, 5, 5, 9, 5 ],
	[ 5, 7, 7, 5, 5, 9, 9, 7, 5, 5, 1, 5, 5, 5, 1, 5 ],
	[ 5, 7, 7, 5, 5, 9, 5, 5, 9, 8, 5, 5, 9, 7, 8, 9 ],
	[ 7, 7, 5, 5, 5, 8, 7, 1, 5, 5, 8, 1, 5, 5, 7, 5 ]
],
"objects": [
	{
		"class": "io.github.pokemeetup.system.gameplay.overworld.World$WorldObjectData",
		"x": 4608,
		"y": -15776,
		"type": "RUINS_TREE"
	},
	{
		"class": "io.github.pokemeetup.system.gameplay.overworld.World$WorldObjectData",
		"x": 4672,
		"y": -15872,
		"type": "POKEBALL"
	}
],
"blocks": [],
"lastModified": 0,
"isMultiplayer": false
}