{
"x": 3,
"y": -35,
"biomeType": "RUINS",
"tileData": [
	[ 12, 11, 1, 11, 12, 53, 55, 54, 56, 56, 56, 56, 56, 56, 54, 56 ],
	[ 11, 11, 11, 11, 56, 56, 56, 56, 56, 56, 56, 55, 54, 56, 56, 56 ],
	[ 12, 11, 11, 11, 56, 54, 56, 54, 53, 56, 56, 56, 56, 56, 53, 56 ],
	[ 11, 11, 53, 54, 56, 56, 56, 56, 56, 56, 56, 56, 56, 56, 53, 56 ],
	[ 11, 55, 54, 12, 56, 53, 53, 56, 56, 54, 56, 56, 56, 56, 56, 56 ],
	[ 20, 10, 56, 53, 54, 56, 55, 55, 56, 56, 55, 56, 56, 56, 56, 55 ],
	[ 54, 56, 56, 55, 54, 53, 56, 54, 56, 56, 55, 55, 56, 56, 56, 55 ],
	[ 20, 12, 12, 53, 56, 56, 54, 56, 56, 54, 56, 53, 54, 56, 55, 56 ],
	[ 53, 56, 56, 53, 54, 56, 56, 54, 56, 53, 56, 56, 56, 56, 56, 54 ],
	[ 56, 56, 56, 56, 56, 56, 56, 56, 56, 56, 56, 53, 56, 56, 54, 53 ],
	[ 56, 53, 56, 56, 56, 56, 54, 53, 56, 54, 54, 56, 54, 56, 56, 56 ],
	[ 56, 55, 54, 56, 54, 55, 56, 56, 54, 56, 56, 55, 56, 56, 56, 56 ],
	[ 54, 54, 56, 55, 56, 56, 56, 54, 53, 56, 56, 54, 55, 53, 54, 56 ],
	[ 55, 54, 54, 54, 56, 56, 56, 53, 53, 54, 54, 56, 56, 56, 56, 56 ],
	[ 54, 56, 56, 56, 56, 56, 56, 56, 54, 56, 55, 56, 56, 54, 56, 56 ],
	[ 56, 53, 56, 56, 56, 53, 56, 55, 56, 56, 53, 54, 56, 54, 56, 54 ]
],
"objects": [
	{
		"class": "io.github.pokemeetup.system.gameplay.overworld.World$WorldObjectData",
		"x": 1696,
		"y": -17888,
		"type": "TREE_0"
	},
	{
		"class": "io.github.pokemeetup.system.gameplay.overworld.World$WorldObjectData",
		"x": 1600,
		"y": -17888,
		"type": "TREE_0"
	},
	{
		"class": "io.github.pokemeetup.system.gameplay.overworld.World$WorldObjectData",
		"x": 1536,
		"y": -17792,
		"type": "TREE_1"
	}
],
"blocks": [],
"lastModified": 0,
"isMultiplayer": false
}