{
"x": 4,
"y": -49,
"biomeType": "RUINS",
"tileData": [
	[ 12, 56, 53, 56, 53, 53, 53, 54, 54, 56, 56, 56, 54, 56, 56, 56 ],
	[ 56, 56, 56, 53, 56, 56, 54, 55, 56, 56, 55, 56, 54, 54, 54, 56 ],
	[ 53, 53, 56, 56, 56, 55, 56, 56, 56, 56, 56, 56, 55, 56, 56, 56 ],
	[ 56, 54, 56, 56, 56, 56, 56, 56, 55, 56, 53, 56, 53, 56, 56, 56 ],
	[ 56, 54, 56, 56, 55, 54, 53, 56, 53, 56, 56, 56, 53, 56, 55, 55 ],
	[ 56, 56, 56, 55, 56, 56, 56, 56, 56, 56, 56, 53, 56, 54, 55, 56 ],
	[ 56, 56, 56, 56, 56, 56, 56, 56, 56, 56, 54, 56, 56, 56, 54, 56 ],
	[ 54, 54, 53, 56, 55, 56, 56, 56, 55, 56, 56, 56, 56, 56, 55, 55 ],
	[ 56, 56, 56, 56, 54, 55, 54, 55, 53, 56, 55, 54, 53, 54, 55, 56 ],
	[ 54, 53, 53, 56, 56, 56, 56, 56, 56, 56, 54, 56, 56, 53, 56, 56 ],
	[ 56, 54, 56, 56, 56, 55, 54, 56, 56, 54, 56, 56, 56, 56, 53, 56 ],
	[ 56, 56, 53, 54, 56, 56, 56, 56, 54, 56, 56, 56, 56, 53, 56, 56 ],
	[ 56, 53, 56, 56, 56, 53, 55, 56, 56, 56, 56, 53, 56, 55, 55, 56 ],
	[ 53, 56, 56, 53, 53, 56, 54, 56, 56, 56, 56, 56, 54, 56, 56, 54 ],
	[ 53, 55, 56, 53, 56, 53, 53, 54, 55, 56, 56, 56, 56, 53, 53, 56 ],
	[ 54, 53, 56, 55, 56, 54, 56, 56, 53, 53, 56, 54, 56, 56, 56, 53 ]
],
"objects": [],
"blocks": [],
"lastModified": 0,
"isMultiplayer": false
}