{
"x": -28,
"y": -85,
"biomeType": "FOREST",
"tileData": [
	[ 1, 11, 11, 11, 11, 11, 12, 12, 12, 11, 12, 11, 11, 12, 11, 11 ],
	[ 1, 12, 1, 11, 11, 12, 12, 11, 1, 11, 11, 11, 11, 1, 1, 11 ],
	[ 12, 1, 11, 12, 12, 12, 12, 1, 12, 11, 11, 12, 11, 11, 11, 1 ],
	[ 20, 11, 11, 1, 12, 11, 12, 11, 11, 11, 12, 1, 1, 12, 11, 11 ],
	[ 11, 11, 11, 12, 12, 12, 11, 11, 11, 1, 1, 11, 12, 20, 11, 12 ],
	[ 11, 12, 1, 12, 12, 11, 11, 11, 12, 12, 11, 11, 1, 11, 11, 12 ],
	[ 12, 12, 12, 11, 20, 11, 11, 11, 11, 11, 12, 12, 11, 12, 10, 12 ],
	[ 11, 12, 11, 11, 12, 11, 12, 12, 11, 1, 12, 11, 11, 12, 1, 10 ],
	[ 11, 11, 1, 12, 12, 12, 11, 11, 11, 11, 11, 11, 12, 11, 11, 1 ],
	[ 11, 11, 11, 11, 12, 12, 1, 11, 1, 11, 12, 12, 12, 11, 12, 11 ],
	[ 11, 11, 11, 12, 12, 1, 11, 11, 11, 11, 11, 1, 11, 11, 11, 11 ],
	[ 11, 11, 11, 1, 11, 12, 11, 11, 20, 1, 11, 12, 12, 1, 11, 12 ],
	[ 12, 11, 11, 12, 12, 11, 11, 12, 10, 11, 12, 11, 11, 11, 11, 1 ],
	[ 11, 12, 11, 11, 12, 11, 11, 10, 1, 11, 12, 12, 11, 11, 11, 10 ],
	[ 1, 11, 12, 12, 11, 11, 12, 12, 11, 1, 11, 11, 11, 12, 11, 1 ],
	[ 11, 12, 11, 11, 12, 12, 1, 12, 12, 11, 11, 11, 11, 11, 11, 11 ]
],
"objects": [
	{
		"class": "io.github.pokemeetup.system.gameplay.overworld.World$WorldObjectData",
		"x": -14048,
		"y": -43264,
		"type": "POKEBALL"
	}
],
"blocks": [],
"lastModified": 0,
"isMultiplayer": false
}