{
"x": 4,
"y": -46,
"biomeType": "FOREST",
"tileData": [
	[ 56, 54, 56, 53, 11, 12, 11, 11, 1, 11, 11, 11, 11, 12, 11, 11 ],
	[ 54, 56, 53, 11, 12, 11, 11, 12, 12, 12, 11, 11, 11, 1, 1, 11 ],
	[ 56, 56, 11, 11, 12, 11, 12, 12, 11, 11, 11, 10, 12, 10, 11, 12 ],
	[ 53, 56, 12, 12, 56, 11, 12, 12, 11, 12, 1, 12, 11, 11, 11, 11 ],
	[ 56, 53, 1, 1, 1, 12, 11, 11, 12, 12, 11, 11, 11, 11, 11, 12 ],
	[ 1, 10, 11, 12, 12, 11, 11, 11, 11, 12, 1, 1, 11, 11, 1, 10 ],
	[ 12, 11, 54, 11, 11, 11, 1, 10, 12, 1, 12, 11, 11, 12, 11, 11 ],
	[ 11, 1, 1, 11, 11, 11, 12, 20, 1, 12, 11, 11, 1, 10, 11, 1 ],
	[ 12, 12, 11, 11, 12, 12, 11, 11, 1, 11, 11, 12, 11, 11, 12, 20 ],
	[ 12, 11, 11, 12, 12, 11, 11, 10, 11, 11, 1, 11, 12, 1, 20, 11 ],
	[ 11, 11, 11, 1, 11, 11, 12, 11, 11, 12, 12, 10, 1, 1, 11, 11 ],
	[ 11, 1, 1, 11, 12, 1, 11, 11, 12, 11, 11, 1, 11, 12, 11, 12 ],
	[ 12, 1, 1, 11, 12, 11, 11, 1, 12, 12, 12, 11, 11, 11, 12, 1 ],
	[ 56, 56, 12, 1, 11, 11, 12, 12, 10, 11, 11, 11, 12, 1, 11, 11 ],
	[ 55, 56, 11, 11, 11, 12, 11, 11, 12, 11, 11, 11, 12, 10, 11, 1 ],
	[ 56, 54, 56, 11, 10, 11, 11, 12, 1, 11, 11, 11, 1, 1, 1, 1 ]
],
"objects": [
	{
		"class": "io.github.pokemeetup.system.gameplay.overworld.World$WorldObjectData",
		"x": 2528,
		"y": -23552,
		"type": "RUINS_TREE"
	},
	{
		"class": "io.github.pokemeetup.system.gameplay.overworld.World$WorldObjectData",
		"x": 2112,
		"y": -23520,
		"type": "RUINS_TREE"
	},
	{
		"class": "io.github.pokemeetup.system.gameplay.overworld.World$WorldObjectData",
		"x": 2176,
		"y": -23552,
		"type": "RUIN_POLE"
	},
	{
		"class": "io.github.pokemeetup.system.gameplay.overworld.World$WorldObjectData",
		"x": 2272,
		"y": -23520,
		"type": "POKEBALL"
	}
],
"blocks": [],
"lastModified": 0,
"isMultiplayer": false
}