{
"x": 3,
"y": -47,
"biomeType": "RUINS",
"tileData": [
	[ 56, 56, 56, 54, 56, 54, 55, 56, 56, 53, 56, 56, 55, 56, 56, 56 ],
	[ 56, 54, 56, 56, 54, 54, 56, 56, 54, 56, 54, 56, 55, 53, 56, 53 ],
	[ 53, 54, 56, 53, 54, 56, 56, 53, 53, 54, 56, 56, 56, 56, 56, 54 ],
	[ 56, 54, 56, 56, 56, 56, 56, 56, 56, 56, 54, 56, 56, 56, 54, 56 ],
	[ 56, 56, 53, 56, 56, 55, 53, 56, 56, 56, 56, 53, 56, 55, 56, 55 ],
	[ 55, 56, 56, 56, 56, 55, 54, 56, 56, 56, 56, 56, 56, 56, 56, 56 ],
	[ 55, 56, 56, 56, 56, 56, 54, 54, 56, 53, 56, 56, 56, 56, 56, 56 ],
	[ 56, 56, 54, 55, 56, 56, 53, 56, 56, 54, 56, 56, 54, 54, 53, 53 ],
	[ 56, 53, 56, 56, 56, 56, 53, 53, 55, 56, 56, 56, 55, 53, 56, 56 ],
	[ 56, 54, 53, 56, 56, 53, 53, 56, 54, 55, 56, 54, 56, 56, 54, 56 ],
	[ 56, 56, 56, 56, 56, 56, 56, 56, 56, 54, 56, 53, 53, 53, 56, 56 ],
	[ 53, 56, 54, 53, 55, 54, 56, 56, 54, 54, 56, 55, 55, 56, 56, 56 ],
	[ 56, 56, 56, 56, 56, 54, 56, 55, 56, 56, 56, 56, 55, 55, 56, 56 ],
	[ 55, 56, 56, 54, 56, 54, 56, 56, 53, 56, 56, 54, 56, 55, 56, 53 ],
	[ 56, 56, 53, 55, 56, 55, 56, 56, 56, 56, 56, 56, 56, 56, 55, 53 ],
	[ 53, 56, 54, 55, 56, 56, 56, 55, 55, 56, 53, 56, 56, 56, 53, 56 ]
],
"objects": [],
"blocks": [],
"lastModified": 0,
"isMultiplayer": false
}