{
"x": 6,
"y": -35,
"biomeType": "RUINS",
"tileData": [
	[ 12, 1, 10, 54, 56, 56, 56, 56, 56, 54, 54, 56, 53, 54, 55, 53 ],
	[ 11, 1, 11, 53, 53, 56, 54, 53, 54, 53, 56, 56, 54, 56, 11, 56 ],
	[ 1, 12, 53, 56, 56, 55, 55, 56, 53, 56, 54, 55, 1, 10, 12, 56 ],
	[ 56, 56, 56, 56, 56, 56, 56, 56, 56, 56, 56, 56, 53, 11, 56, 11 ],
	[ 56, 56, 55, 54, 56, 56, 56, 56, 56, 55, 56, 55, 54, 56, 11, 11 ],
	[ 56, 56, 54, 56, 56, 56, 56, 56, 56, 53, 54, 56, 56, 11, 11, 10 ],
	[ 56, 54, 56, 54, 56, 56, 56, 56, 54, 54, 56, 55, 56, 53, 55, 1 ],
	[ 54, 56, 56, 54, 56, 56, 55, 56, 56, 54, 53, 56, 53, 56, 54, 56 ],
	[ 53, 56, 53, 56, 54, 53, 56, 56, 56, 54, 56, 54, 55, 55, 53, 56 ],
	[ 56, 54, 56, 56, 56, 56, 56, 54, 56, 56, 56, 56, 56, 56, 54, 56 ],
	[ 53, 56, 53, 55, 56, 56, 55, 54, 56, 56, 56, 56, 54, 56, 56, 56 ],
	[ 56, 56, 56, 56, 56, 55, 54, 56, 56, 56, 56, 56, 54, 54, 56, 56 ],
	[ 56, 56, 54, 56, 56, 56, 56, 56, 56, 56, 56, 56, 54, 56, 56, 54 ],
	[ 54, 56, 55, 56, 54, 56, 56, 55, 56, 55, 54, 56, 56, 54, 56, 56 ],
	[ 55, 56, 55, 56, 56, 53, 56, 56, 53, 54, 56, 56, 56, 56, 54, 56 ],
	[ 54, 56, 56, 56, 56, 56, 56, 56, 56, 53, 56, 56, 56, 53, 54, 53 ]
],
"objects": [
	{
		"class": "io.github.pokemeetup.system.gameplay.overworld.World$WorldObjectData",
		"x": 3200,
		"y": -17440,
		"type": "TREE_0"
	},
	{
		"class": "io.github.pokemeetup.system.gameplay.overworld.World$WorldObjectData",
		"x": 3136,
		"y": -17888,
		"type": "TREE_0"
	},
	{
		"class": "io.github.pokemeetup.system.gameplay.overworld.World$WorldObjectData",
		"x": 3264,
		"y": -17440,
		"type": "POKEBALL"
	}
],
"blocks": [],
"lastModified": 0,
"isMultiplayer": false
}