{
"x": 0,
"y": -67,
"biomeType": "RUINS",
"tileData": [
	[ 11, 12, 12, 56, 54, 11, 56, 53, 53, 56, 56, 56, 56, 53, 55, 56 ],
	[ 12, 12, 12, 56, 56, 53, 56, 56, 54, 54, 55, 56, 56, 56, 55, 55 ],
	[ 11, 11, 56, 54, 56, 53, 54, 54, 56, 54, 55, 56, 56, 53, 56, 56 ],
	[ 12, 56, 56, 53, 53, 56, 55, 54, 55, 56, 56, 56, 56, 54, 56, 55 ],
	[ 11, 53, 56, 56, 55, 54, 56, 53, 54, 56, 56, 56, 54, 55, 56, 54 ],
	[ 56, 55, 56, 54, 55, 56, 56, 55, 56, 53, 56, 56, 56, 54, 56, 56 ],
	[ 56, 53, 56, 56, 56, 54, 56, 56, 53, 54, 56, 56, 56, 54, 56, 56 ],
	[ 53, 54, 54, 54, 54, 56, 56, 56, 56, 56, 53, 56, 54, 56, 56, 56 ],
	[ 56, 56, 56, 53, 55, 56, 56, 55, 54, 56, 56, 55, 56, 53, 56, 54 ],
	[ 55, 56, 53, 54, 53, 53, 56, 56, 55, 56, 56, 56, 56, 56, 53, 53 ],
	[ 56, 56, 55, 53, 56, 56, 56, 53, 56, 54, 55, 56, 55, 56, 56, 56 ],
	[ 56, 56, 53, 56, 55, 53, 56, 55, 56, 56, 55, 54, 54, 54, 56, 56 ],
	[ 56, 56, 56, 56, 56, 55, 56, 56, 56, 53, 56, 55, 54, 55, 56, 56 ],
	[ 56, 56, 55, 56, 56, 54, 54, 56, 54, 56, 54, 56, 56, 56, 56, 53 ],
	[ 53, 56, 53, 56, 56, 56, 56, 56, 56, 55, 54, 56, 53, 56, 53, 56 ],
	[ 56, 54, 53, 56, 55, 56, 56, 56, 55, 56, 56, 56, 53, 56, 55, 54 ]
],
"objects": [
	{
		"class": "io.github.pokemeetup.system.gameplay.overworld.World$WorldObjectData",
		"x": 64,
		"y": -34272,
		"type": "TREE_0"
	}
],
"blocks": [],
"lastModified": 0,
"isMultiplayer": false
}