{
"x": 3,
"y": -42,
"biomeType": "HAUNTED",
"tileData": [
	[ 2, 15, 15, 17, 15, 15, 15, 15, 15, 17, 17, 15, 15, 2, 2, 15 ],
	[ 15, 15, 15, 15, 15, 15, 15, 15, 17, 15, 15, 2, 15, 15, 15, 2 ],
	[ 8, 5, 5, 5, 5, 15, 15, 2, 15, 15, 15, 17, 15, 15, 8, 7 ],
	[ 9, 9, 5, 5, 5, 7, 5, 5, 5, 7, 5, 7, 5, 5, 9, 5 ],
	[ 5, 5, 8, 5, 5, 5, 9, 5, 5, 7, 5, 8, 5, 5, 5, 5 ],
	[ 5, 8, 7, 8, 5, 7, 8, 5, 7, 7, 8, 7, 5, 5, 5, 8 ],
	[ 5, 5, 10, 7, 5, 5, 5, 5, 7, 7, 7, 7, 5, 5, 5, 7 ],
	[ 7, 5, 9, 5, 5, 5, 5, 5, 5, 5, 5, 5, 5, 7, 7, 7 ],
	[ 5, 8, 5, 5, 5, 7, 7, 5, 5, 5, 5, 5, 5, 8, 7, 5 ],
	[ 1, 5, 5, 7, 7, 9, 8, 5, 7, 5, 5, 8, 9, 7, 7, 7 ],
	[ 7, 5, 7, 8, 1, 5, 5, 5, 5, 5, 9, 5, 7, 7, 5, 5 ],
	[ 5, 7, 5, 7, 5, 8, 5, 5, 5, 5, 9, 5, 8, 7, 5, 5 ],
	[ 7, 5, 7, 5, 7, 5, 5, 7, 9, 5, 1, 7, 5, 5, 5, 5 ],
	[ 5, 1, 5, 7, 9, 5, 5, 7, 5, 7, 8, 5, 5, 5, 7, 1 ],
	[ 7, 7, 5, 9, 5, 7, 5, 5, 7, 9, 5, 5, 5, 8, 7, 8 ],
	[ 5, 5, 7, 5, 5, 7, 7, 8, 7, 7, 7, 5, 8, 7, 7, 1 ]
],
"objects": [
	{
		"class": "io.github.pokemeetup.system.gameplay.overworld.World$WorldObjectData",
		"x": 1568,
		"y": -21152,
		"type": "CACTUS"
	},
	{
		"class": "io.github.pokemeetup.system.gameplay.overworld.World$WorldObjectData",
		"x": 1568,
		"y": -21280,
		"type": "CACTUS"
	},
	{
		"class": "io.github.pokemeetup.system.gameplay.overworld.World$WorldObjectData",
		"x": 1568,
		"y": -21024,
		"type": "POKEBALL"
	}
],
"blocks": [],
"lastModified": 0,
"isMultiplayer": false
}