{
"x": -24,
"y": -82,
"biomeType": "PLAINS",
"tileData": [
	[ 56, 56, 54, 10, 1, 10, 1, 10, 1, 10, 1, 1, 1, 10, 1, 1 ],
	[ 1, 55, 1, 10, 1, 1, 24, 10, 10, 1, 1, 1, 10, 1, 24, 10 ],
	[ 24, 56, 56, 10, 1, 24, 1, 1, 1, 1, 24, 1, 10, 1, 1, 1 ],
	[ 10, 56, 1, 1, 1, 10, 1, 1, 1, 1, 1, 1, 10, 10, 10, 1 ],
	[ 1, 56, 1, 24, 23, 24, 1, 1, 1, 10, 10, 1, 22, 10, 10, 1 ],
	[ 1, 53, 10, 10, 1, 10, 1, 1, 1, 10, 1, 1, 1, 10, 24, 10 ],
	[ 56, 1, 10, 1, 10, 1, 10, 1, 1, 10, 10, 10, 1, 1, 24, 1 ],
	[ 1, 10, 24, 1, 1, 10, 1, 10, 1, 24, 1, 1, 1, 10, 1, 24 ],
	[ 1, 1, 1, 1, 10, 1, 10, 24, 1, 10, 1, 10, 10, 24, 24, 1 ],
	[ 1, 1, 1, 10, 1, 1, 1, 1, 10, 10, 10, 1, 10, 1, 24, 1 ],
	[ 1, 1, 10, 1, 1, 10, 10, 1, 1, 1, 1, 10, 10, 10, 1, 1 ],
	[ 1, 1, 1, 10, 24, 1, 1, 1, 24, 10, 10, 1, 1, 10, 1, 10 ],
	[ 24, 10, 24, 10, 10, 1, 1, 24, 1, 1, 1, 10, 1, 10, 1, 10 ],
	[ 1, 1, 1, 1, 1, 1, 10, 1, 10, 10, 10, 1, 1, 10, 10, 10 ],
	[ 24, 24, 10, 10, 10, 24, 10, 10, 24, 1, 1, 1, 10, 10, 10, 1 ],
	[ 1, 24, 1, 1, 1, 10, 1, 10, 1, 1, 1, 10, 10, 1, 24, 1 ]
],
"objects": [
	{
		"class": "io.github.pokemeetup.system.gameplay.overworld.World$WorldObjectData",
		"x": -12128,
		"y": -41952,
		"type": "RUINS_TREE"
	},
	{
		"class": "io.github.pokemeetup.system.gameplay.overworld.World$WorldObjectData",
		"x": -12224,
		"y": -41952,
		"type": "RUINS_TREE"
	},
	{
		"class": "io.github.pokemeetup.system.gameplay.overworld.World$WorldObjectData",
		"x": -11904,
		"y": -41536,
		"type": "POKEBALL"
	}
],
"blocks": [],
"lastModified": 0,
"isMultiplayer": false
}