{
"x": -16,
"y": -82,
"biomeType": "SNOW",
"tileData": [
	[ 1, 10, 10, 4, 51, 4, 51, 4, 4, 4, 6, 4, 4, 6, 4, 4 ],
	[ 4, 4, 4, 4, 4, 4, 4, 4, 4, 4, 4, 51, 4, 4, 4, 4 ],
	[ 4, 4, 4, 6, 6, 52, 4, 6, 6, 6, 4, 4, 4, 4, 4, 4 ],
	[ 4, 4, 4, 4, 4, 4, 4, 6, 4, 4, 4, 4, 4, 4, 4, 4 ],
	[ 6, 4, 6, 4, 4, 6, 4, 6, 6, 51, 4, 4, 4, 6, 4, 4 ],
	[ 4, 51, 4, 4, 51, 51, 51, 4, 51, 4, 4, 52, 4, 4, 51, 4 ],
	[ 4, 4, 4, 4, 4, 4, 4, 4, 4, 4, 4, 6, 4, 4, 4, 4 ],
	[ 6, 4, 4, 4, 4, 4, 4, 4, 51, 6, 4, 4, 4, 4, 4, 4 ],
	[ 4, 4, 4, 51, 6, 51, 4, 52, 4, 6, 4, 4, 4, 6, 4, 4 ],
	[ 4, 4, 4, 4, 4, 4, 4, 4, 4, 4, 4, 4, 4, 4, 4, 4 ],
	[ 4, 4, 4, 51, 4, 4, 4, 4, 4, 4, 4, 52, 4, 4, 4, 4 ],
	[ 51, 4, 4, 4, 4, 4, 4, 4, 6, 6, 4, 4, 4, 6, 6, 4 ],
	[ 4, 6, 4, 52, 4, 52, 4, 6, 4, 4, 4, 4, 4, 4, 4, 4 ],
	[ 4, 4, 4, 4, 51, 4, 4, 51, 6, 4, 4, 4, 4, 6, 4, 4 ],
	[ 4, 4, 52, 4, 4, 51, 6, 4, 4, 6, 52, 4, 4, 51, 4, 4 ],
	[ 4, 4, 51, 51, 4, 4, 4, 4, 6, 6, 4, 4, 4, 4, 4, 4 ]
],
"objects": [
	{
		"class": "io.github.pokemeetup.system.gameplay.overworld.World$WorldObjectData",
		"x": -8192,
		"y": -41984,
		"type": "POKEBALL"
	}
],
"blocks": [],
"lastModified": 0,
"isMultiplayer": false
}