{
"x": -3,
"y": 1,
"biomeType": "HAUNTED",
"tileData": [
	[ 4, 4, 4, 4, 4, 7, 7, 5, 5, 7, 5, 7, 5, 9, 5, 7 ],
	[ 4, 6, 4, 4, 5, 7, 8, 7, 10, 5, 9, 7, 8, 10, 7, 5 ],
	[ 4, 51, 4, 4, 5, 5, 7, 5, 5, 5, 7, 7, 7, 5, 5, 9 ],
	[ 4, 4, 4, 4, 7, 9, 9, 9, 5, 5, 5, 7, 5, 7, 7, 5 ],
	[ 4, 4, 4, 4, 5, 5, 5, 5, 5, 5, 5, 5, 8, 5, 5, 7 ],
	[ 51, 52, 4, 7, 8, 5, 5, 5, 5, 5, 8, 5, 5, 5, 5, 5 ],
	[ 4, 4, 4, 7, 7, 5, 5, 5, 9, 5, 5, 5, 5, 7, 7, 8 ],
	[ 51, 4, 5, 7, 5, 5, 5, 5, 5, 1, 5, 5, 9, 7, 5, 5 ],
	[ 4, 51, 5, 5, 7, 10, 5, 7, 9, 5, 5, 7, 7, 5, 5, 8 ],
	[ 12, 4, 5, 5, 7, 7, 5, 5, 5, 5, 7, 5, 5, 5, 7, 5 ],
	[ 11, 11, 5, 1, 9, 5, 5, 9, 5, 5, 5, 9, 5, 5, 5, 5 ],
	[ 11, 1, 8, 7, 5, 1, 5, 5, 7, 8, 7, 5, 7, 5, 5, 7 ],
	[ 10, 12, 12, 9, 5, 5, 5, 7, 5, 7, 5, 1, 7, 5, 5, 7 ],
	[ 1, 1, 11, 5, 5, 5, 5, 5, 7, 9, 7, 5, 5, 5, 5, 9 ],
	[ 11, 20, 11, 11, 5, 5, 7, 5, 8, 5, 5, 5, 5, 5, 5, 9 ],
	[ 10, 12, 12, 11, 9, 7, 8, 5, 5, 9, 5, 7, 7, 5, 5, 5 ]
],
"objects": [
	{
		"class": "io.github.pokemeetup.system.gameplay.overworld.World$WorldObjectData",
		"x": -1280,
		"y": 544,
		"type": "SNOW_TREE"
	},
	{
		"class": "io.github.pokemeetup.system.gameplay.overworld.World$WorldObjectData",
		"x": -1312,
		"y": 800,
		"type": "POKEBALL"
	}
],
"blocks": [],
"lastModified": 0,
"isMultiplayer": false
}