{
"x": 3,
"y": -48,
"biomeType": "RUINS",
"tileData": [
	[ 11, 12, 11, 11, 11, 11, 12, 12, 10, 11, 11, 54, 56, 54, 56, 55 ],
	[ 12, 11, 11, 11, 12, 11, 11, 12, 53, 56, 56, 56, 12, 56, 56, 56 ],
	[ 11, 11, 11, 12, 11, 56, 55, 56, 53, 56, 56, 56, 54, 56, 56, 56 ],
	[ 12, 1, 12, 56, 56, 56, 53, 53, 56, 54, 56, 53, 55, 56, 56, 53 ],
	[ 11, 54, 56, 11, 53, 54, 56, 54, 56, 55, 56, 56, 56, 56, 56, 54 ],
	[ 12, 54, 53, 56, 56, 56, 56, 56, 56, 56, 54, 56, 56, 56, 54, 56 ],
	[ 56, 54, 56, 56, 56, 54, 56, 56, 56, 56, 56, 56, 56, 56, 56, 56 ],
	[ 56, 56, 56, 56, 56, 56, 56, 56, 54, 56, 53, 54, 56, 56, 54, 54 ],
	[ 55, 56, 56, 56, 53, 56, 56, 55, 54, 56, 56, 55, 56, 56, 56, 56 ],
	[ 56, 56, 56, 56, 55, 56, 54, 56, 53, 56, 56, 56, 56, 53, 56, 56 ],
	[ 56, 56, 56, 55, 54, 56, 56, 53, 56, 55, 56, 54, 56, 56, 56, 56 ],
	[ 56, 53, 56, 56, 56, 56, 56, 56, 54, 55, 56, 54, 53, 55, 54, 56 ],
	[ 55, 56, 55, 56, 54, 56, 56, 56, 56, 54, 55, 56, 53, 54, 54, 56 ],
	[ 56, 55, 54, 53, 56, 53, 53, 55, 56, 56, 56, 56, 56, 55, 56, 56 ],
	[ 53, 56, 54, 56, 56, 53, 56, 55, 56, 56, 56, 56, 56, 56, 53, 54 ],
	[ 55, 54, 56, 55, 56, 56, 56, 56, 56, 56, 56, 54, 56, 54, 56, 56 ]
],
"objects": [
	{
		"class": "io.github.pokemeetup.system.gameplay.overworld.World$WorldObjectData",
		"x": 1568,
		"y": -24352,
		"type": "TREE_0"
	},
	{
		"class": "io.github.pokemeetup.system.gameplay.overworld.World$WorldObjectData",
		"x": 1600,
		"y": -24544,
		"type": "TREE_0"
	},
	{
		"class": "io.github.pokemeetup.system.gameplay.overworld.World$WorldObjectData",
		"x": 1536,
		"y": -24256,
		"type": "TREE_0"
	},
	{
		"class": "io.github.pokemeetup.system.gameplay.overworld.World$WorldObjectData",
		"x": 1536,
		"y": -24448,
		"type": "TREE_1"
	}
],
"blocks": [],
"lastModified": 0,
"isMultiplayer": false
}