{
"biomeType": "HAUNTED",
"tileData": [
	[ 5, 5, 5, 5, 5, 5, 9, 5, 5, 5, 8, 8, 7, 5, 9, 5 ],
	[ 9, 7, 5, 5, 5, 9, 5, 5, 5, 5, 5, 9, 9, 5, 5, 5 ],
	[ 5, 9, 5, 5, 5, 5, 5, 5, 5, 7, 5, 5, 9, 9, 7, 5 ],
	[ 5, 5, 5, 8, 5, 5, 5, 5, 5, 5, 5, 5, 9, 9, 5, 5 ],
	[ 5, 5, 5, 5, 5, 5, 5, 7, 5, 5, 5, 9, 9, 5, 5, 5 ],
	[ 7, 7, 5, 7, 5, 5, 9, 5, 5, 5, 5, 9, 7, 5, 5, 5 ],
	[ 5, 5, 5, 7, 5, 7, 5, 5, 7, 7, 5, 9, 9, 5, 5, 5 ],
	[ 9, 5, 9, 5, 9, 5, 9, 5, 7, 5, 5, 7, 9, 5, 9, 5 ],
	[ 9, 5, 5, 5, 5, 5, 5, 5, 5, 7, 9, 5, 5, 5, 7, 5 ],
	[ 8, 8, 5, 7, 5, 5, 9, 9, 5, 5, 5, 8, 5, 5, 5, 7 ],
	[ 5, 5, 5, 5, 5, 7, 5, 9, 5, 5, 9, 5, 8, 5, 7, 5 ],
	[ 5, 9, 5, 8, 8, 9, 8, 5, 9, 7, 9, 5, 5, 7, 7, 5 ],
	[ 5, 9, 5, 5, 8, 5, 5, 8, 5, 9, 7, 5, 5, 9, 5, 5 ],
	[ 7, 5, 5, 9, 5, 5, 9, 5, 5, 7, 8, 9, 9, 5, 5, 5 ],
	[ 5, 7, 7, 5, 5, 5, 5, 5, 5, 5, 5, 5, 9, 5, 8, 5 ],
	[ 5, 5, 9, 5, 5, 5, 7, 5, 5, 5, 9, 5, 9, 5, 7, 9 ]
],
"objects": [
	{
		"x": 256,
		"y": 160,
		"type": "HAUNTED_TREE"
	}
],
"lastModified": 1730175588116
}