{
"x": 3,
"y": 6,
"biomeType": "PLAINS",
"tileData": [
	[ 10, 1, 10, 1, 1, 1, 1, 1, 1, 1, 1, 10, 1, 1, 1, 1 ],
	[ 1, 1, 10, 1, 1, 10, 1, 1, 1, 10, 1, 10, 10, 1, 1, 1 ],
	[ 10, 10, 1, 1, 10, 1, 1, 10, 10, 10, 1, 1, 1, 1, 1, 1 ],
	[ 10, 10, 1, 10, 1, 1, 1, 1, 1, 1, 1, 10, 1, 1, 1, 10 ],
	[ 1, 1, 10, 1, 1, 1, 1, 10, 1, 1, 1, 10, 1, 1, 10, 1 ],
	[ 1, 1, 1, 1, 1, 1, 1, 1, 1, 10, 1, 1, 10, 1, 1, 1 ],
	[ 1, 1, 1, 1, 1, 1, 1, 1, 1, 1, 1, 1, 1, 1, 1, 1 ],
	[ 1, 1, 10, 1, 10, 10, 10, 1, 1, 1, 1, 1, 1, 1, 1, 10 ],
	[ 1, 1, 10, 1, 1, 10, 1, 1, 1, 1, 10, 1, 1, 1, 1, 1 ],
	[ 1, 1, 1, 1, 10, 1, 1, 1, 1, 1, 1, 10, 1, 1, 1, 1 ],
	[ 10, 1, 1, 10, 10, 1, 10, 10, 10, 1, 1, 1, 1, 1, 1, 10 ],
	[ 1, 1, 1, 1, 1, 10, 10, 10, 1, 1, 1, 1, 1, 1, 1, 1 ],
	[ 1, 1, 1, 1, 1, 1, 1, 1, 1, 1, 10, 1, 1, 1, 10, 1 ],
	[ 1, 1, 1, 1, 1, 1, 1, 1, 10, 1, 1, 1, 1, 10, 1, 1 ],
	[ 1, 1, 1, 1, 10, 1, 10, 10, 1, 1, 10, 1, 10, 1, 1, 1 ],
	[ 1, 1, 10, 1, 1, 10, 1, 10, 10, 1, 1, 1, 1, 1, 1, 1 ]
],
"objects": [
	{
		"x": 1888,
		"y": 3392,
		"type": "TREE"
	}
],
"lastModified": 1730175590946
}