{
"x": -2,
"y": 11,
"biomeType": "PLAINS",
"tileData": [
	[ 10, 1, 1, 1, 1, 1, 10, 1, 1, 1, 1, 10, 1, 1, 1, 10 ],
	[ 1, 10, 1, 10, 10, 1, 10, 10, 1, 1, 1, 1, 1, 1, 10, 1 ],
	[ 1, 1, 1, 1, 1, 1, 1, 1, 1, 1, 1, 1, 10, 1, 1, 1 ],
	[ 1, 10, 1, 1, 1, 1, 1, 1, 1, 1, 1, 10, 1, 1, 1, 1 ],
	[ 1, 1, 1, 1, 1, 1, 10, 1, 1, 10, 1, 10, 10, 1, 10, 10 ],
	[ 1, 10, 1, 1, 10, 1, 1, 1, 1, 1, 1, 10, 1, 1, 1, 10 ],
	[ 1, 10, 1, 1, 1, 1, 1, 1, 1, 1, 1, 1, 1, 1, 1, 10 ],
	[ 10, 1, 1, 1, 10, 1, 10, 1, 10, 1, 10, 1, 1, 1, 1, 1 ],
	[ 1, 1, 10, 1, 10, 10, 1, 1, 1, 1, 1, 1, 10, 1, 10, 1 ],
	[ 1, 1, 1, 1, 1, 1, 10, 1, 10, 10, 1, 1, 1, 1, 1, 10 ],
	[ 1, 1, 1, 1, 1, 1, 1, 1, 1, 1, 1, 10, 1, 1, 1, 10 ],
	[ 10, 1, 1, 1, 1, 1, 1, 1, 1, 1, 10, 1, 10, 1, 1, 1 ],
	[ 10, 1, 1, 1, 1, 1, 1, 1, 1, 1, 10, 1, 1, 1, 1, 1 ],
	[ 1, 10, 1, 1, 1, 1, 10, 1, 1, 1, 1, 1, 10, 1, 1, 1 ],
	[ 1, 1, 1, 1, 1, 1, 10, 10, 1, 1, 10, 1, 1, 1, 1, 1 ],
	[ 1, 1, 10, 10, 1, 1, 1, 1, 1, 1, 1, 1, 10, 10, 1, 1 ]
],
"objects": [
	{
		"x": -832,
		"y": 5856,
		"type": "TREE"
	}
],
"lastModified": 1730208108002
}