{
"x": 4,
"y": 7,
"biomeType": "PLAINS",
"tileData": [
	[ 1, 1, 1, 1, 1, 10, 1, 10, 1, 1, 1, 1, 1, 1, 1, 10 ],
	[ 10, 1, 1, 1, 10, 10, 1, 1, 1, 1, 1, 1, 1, 1, 1, 1 ],
	[ 1, 10, 1, 1, 1, 1, 1, 10, 1, 1, 1, 1, 10, 1, 1, 1 ],
	[ 1, 1, 1, 1, 1, 1, 1, 1, 1, 1, 1, 1, 10, 10, 1, 1 ],
	[ 10, 1, 1, 1, 10, 1, 1, 1, 1, 1, 10, 1, 10, 10, 1, 1 ],
	[ 10, 1, 10, 1, 1, 1, 1, 1, 10, 1, 1, 1, 1, 1, 1, 1 ],
	[ 10, 10, 1, 1, 10, 1, 1, 1, 1, 1, 1, 1, 1, 1, 1, 1 ],
	[ 10, 1, 1, 1, 1, 1, 1, 1, 1, 10, 1, 1, 1, 1, 1, 1 ],
	[ 1, 1, 1, 1, 1, 1, 10, 1, 1, 1, 1, 1, 1, 1, 1, 1 ],
	[ 1, 1, 10, 1, 1, 1, 1, 10, 1, 1, 1, 1, 1, 1, 10, 1 ],
	[ 10, 1, 1, 1, 1, 10, 1, 1, 1, 1, 1, 1, 1, 1, 10, 1 ],
	[ 1, 1, 1, 10, 1, 1, 1, 1, 1, 1, 10, 1, 10, 10, 1, 1 ],
	[ 1, 1, 10, 1, 1, 1, 1, 1, 1, 1, 1, 1, 1, 1, 1, 1 ],
	[ 1, 1, 1, 1, 1, 1, 1, 1, 1, 10, 1, 1, 1, 1, 1, 1 ],
	[ 1, 1, 1, 1, 1, 1, 1, 1, 1, 1, 1, 10, 1, 1, 1, 1 ],
	[ 1, 1, 1, 1, 1, 1, 1, 10, 1, 10, 10, 10, 10, 1, 1, 1 ]
],
"objects": [
	{
		"x": 2304,
		"y": 3744,
		"type": "POKEBALL"
	},
	{
		"x": 2304,
		"y": 3840,
		"type": "POKEBALL"
	},
	{
		"x": 2464,
		"y": 3712,
		"type": "POKEBALL"
	},
	{
		"x": 2464,
		"y": 3904,
		"type": "POKEBALL"
	},
	{
		"x": 2208,
		"y": 4000,
		"type": "POKEBALL"
	},
	{
		"x": 2528,
		"y": 4032,
		"type": "POKEBALL"
	},
	{
		"x": 2496,
		"y": 3584,
		"type": "POKEBALL"
	},
	{
		"x": 2336,
		"y": 3968,
		"type": "POKEBALL"
	}
],
"lastModified": 1730208107998
}