{
"y": 2,
"biomeType": "HAUNTED",
"tileData": [
	[ 9, 5, 5, 9, 7, 5, 8, 9, 5, 7, 5, 5, 9, 9, 8, 9 ],
	[ 9, 5, 5, 7, 5, 5, 5, 5, 9, 7, 5, 8, 8, 7, 7, 5 ],
	[ 9, 7, 5, 7, 5, 9, 5, 5, 5, 7, 9, 7, 8, 8, 9, 9 ],
	[ 5, 5, 9, 5, 7, 5, 5, 5, 9, 5, 5, 5, 5, 5, 5, 9 ],
	[ 5, 9, 5, 5, 5, 9, 7, 5, 5, 5, 5, 5, 5, 7, 7, 5 ],
	[ 5, 7, 5, 5, 5, 7, 5, 5, 9, 5, 5, 5, 9, 9, 5, 7 ],
	[ 5, 5, 5, 5, 5, 9, 9, 5, 7, 5, 5, 5, 8, 9, 9, 5 ],
	[ 5, 5, 5, 7, 5, 9, 7, 5, 5, 5, 7, 5, 5, 5, 5, 5 ],
	[ 7, 5, 5, 7, 5, 5, 5, 9, 5, 5, 9, 5, 5, 9, 5, 5 ],
	[ 5, 5, 5, 5, 5, 9, 5, 9, 9, 5, 9, 7, 9, 9, 7, 5 ],
	[ 9, 5, 7, 5, 5, 9, 5, 5, 5, 7, 5, 5, 5, 5, 5, 5 ],
	[ 5, 5, 9, 7, 5, 7, 7, 5, 8, 5, 5, 7, 7, 5, 5, 5 ],
	[ 8, 7, 8, 5, 9, 9, 7, 5, 5, 5, 5, 5, 5, 7, 5, 5 ],
	[ 5, 5, 5, 5, 8, 5, 5, 9, 9, 5, 9, 9, 7, 5, 9, 5 ],
	[ 5, 5, 7, 5, 5, 5, 7, 7, 5, 5, 9, 5, 7, 5, 5, 7 ],
	[ 9, 9, 9, 5, 9, 5, 7, 9, 5, 5, 7, 9, 5, 5, 5, 8 ]
],
"objects": [
	{
		"x": 320,
		"y": 1248,
		"type": "HAUNTED_TREE"
	}
],
"lastModified": 1730175599429
}