{
"x": -1,
"y": 12,
"biomeType": "PLAINS",
"tileData": [
	[ 10, 1, 1, 1, 10, 1, 1, 1, 10, 1, 1, 1, 1, 1, 1, 1 ],
	[ 1, 1, 1, 10, 1, 1, 1, 10, 1, 1, 10, 1, 10, 1, 1, 1 ],
	[ 10, 1, 10, 1, 1, 1, 1, 1, 10, 1, 10, 1, 1, 1, 1, 1 ],
	[ 1, 1, 1, 1, 1, 10, 10, 1, 1, 1, 1, 1, 1, 10, 10, 1 ],
	[ 1, 1, 1, 1, 1, 10, 1, 1, 1, 1, 1, 1, 1, 1, 1, 1 ],
	[ 10, 1, 1, 1, 10, 1, 1, 1, 1, 1, 1, 1, 1, 1, 10, 1 ],
	[ 10, 1, 1, 1, 1, 10, 1, 1, 1, 1, 10, 10, 10, 1, 1, 10 ],
	[ 1, 1, 1, 1, 1, 1, 1, 1, 1, 1, 1, 1, 1, 1, 1, 1 ],
	[ 1, 1, 1, 1, 1, 1, 1, 1, 1, 1, 1, 10, 1, 1, 1, 10 ],
	[ 1, 1, 1, 10, 1, 1, 1, 1, 1, 1, 1, 1, 1, 1, 1, 1 ],
	[ 10, 1, 1, 1, 1, 10, 10, 1, 1, 1, 1, 10, 1, 10, 1, 1 ],
	[ 1, 1, 1, 10, 1, 1, 1, 10, 10, 1, 10, 1, 1, 10, 10, 1 ],
	[ 1, 10, 1, 10, 1, 10, 1, 10, 1, 1, 1, 10, 1, 1, 10, 1 ],
	[ 1, 1, 1, 1, 1, 10, 1, 1, 10, 1, 1, 1, 10, 1, 10, 10 ],
	[ 1, 1, 1, 10, 1, 1, 1, 1, 1, 1, 1, 1, 1, 1, 1, 1 ],
	[ 1, 1, 1, 1, 1, 1, 1, 1, 1, 1, 1, 1, 10, 1, 1, 10 ]
],
"objects": [
	{
		"x": -448,
		"y": 6368,
		"type": "TREE"
	},
	{
		"x": -448,
		"y": 6496,
		"type": "TREE"
	}
],
"lastModified": 1730248834112
}