{
"x": -2,
"y": -1,
"biomeType": "HAUNTED",
"tileData": [
	[ 9, 5, 7, 5, 5, 9, 7, 7, 9, 5, 5, 7, 9, 5, 5, 9 ],
	[ 9, 8, 5, 5, 9, 5, 5, 9, 5, 5, 9, 5, 7, 5, 5, 5 ],
	[ 5, 9, 5, 8, 5, 5, 5, 5, 9, 7, 5, 5, 9, 9, 5, 7 ],
	[ 5, 5, 5, 5, 8, 5, 5, 9, 7, 5, 9, 5, 5, 5, 5, 5 ],
	[ 5, 5, 5, 5, 5, 9, 5, 8, 5, 7, 5, 5, 5, 5, 5, 5 ],
	[ 5, 7, 5, 9, 5, 9, 9, 5, 9, 7, 5, 9, 5, 5, 5, 5 ],
	[ 5, 9, 5, 5, 5, 5, 9, 9, 5, 5, 5, 5, 9, 5, 9, 9 ],
	[ 7, 7, 7, 5, 5, 5, 5, 5, 5, 5, 9, 5, 7, 5, 5, 5 ],
	[ 5, 7, 8, 5, 5, 5, 5, 7, 9, 5, 7, 8, 7, 8, 5, 5 ],
	[ 5, 5, 5, 5, 5, 5, 5, 5, 9, 9, 9, 5, 5, 5, 5, 5 ],
	[ 5, 5, 5, 7, 5, 5, 5, 7, 9, 5, 5, 5, 5, 5, 9, 5 ],
	[ 7, 5, 5, 7, 9, 9, 5, 5, 7, 5, 9, 5, 5, 9, 5, 5 ],
	[ 9, 5, 7, 7, 5, 7, 7, 7, 9, 5, 7, 5, 5, 5, 7, 5 ],
	[ 9, 7, 5, 7, 5, 5, 5, 5, 5, 5, 5, 5, 5, 5, 5, 5 ],
	[ 9, 5, 9, 5, 5, 5, 9, 5, 5, 5, 9, 9, 9, 5, 5, 5 ],
	[ 5, 5, 9, 5, 7, 5, 5, 9, 5, 5, 5, 9, 5, 5, 5, 5 ]
],
"objects": [
	{
		"x": -736,
		"y": -384,
		"type": "HAUNTED_TREE"
	}
],
"lastModified": 1730175585558
}