{
"x": 3,
"y": 2,
"biomeType": "HAUNTED",
"tileData": [
	[ 5, 9, 5, 7, 5, 5, 5, 7, 8, 9, 5, 7, 9, 5, 5, 5 ],
	[ 5, 9, 5, 5, 5, 7, 5, 9, 5, 5, 7, 9, 9, 7, 5, 7 ],
	[ 5, 5, 5, 5, 5, 5, 5, 8, 5, 5, 5, 5, 5, 5, 9, 5 ],
	[ 5, 5, 9, 7, 7, 5, 5, 5, 7, 5, 5, 7, 5, 9, 5, 7 ],
	[ 5, 5, 9, 5, 5, 5, 9, 5, 5, 5, 9, 5, 5, 5, 7, 5 ],
	[ 7, 5, 5, 5, 5, 9, 5, 9, 5, 5, 5, 5, 5, 5, 5, 9 ],
	[ 5, 9, 5, 5, 5, 5, 5, 9, 5, 5, 5, 5, 7, 5, 5, 9 ],
	[ 5, 5, 5, 5, 9, 5, 5, 7, 5, 5, 5, 9, 7, 5, 7, 7 ],
	[ 9, 5, 8, 9, 5, 7, 5, 8, 5, 5, 7, 5, 5, 5, 5, 9 ],
	[ 5, 5, 5, 5, 5, 5, 9, 5, 5, 5, 9, 5, 9, 5, 5, 5 ],
	[ 5, 8, 5, 5, 7, 9, 9, 5, 7, 7, 5, 5, 5, 9, 5, 5 ],
	[ 9, 5, 8, 5, 9, 5, 7, 9, 5, 5, 7, 5, 5, 9, 5, 5 ],
	[ 5, 5, 7, 7, 5, 5, 5, 5, 9, 9, 5, 5, 9, 5, 9, 9 ],
	[ 5, 5, 9, 7, 9, 5, 7, 9, 5, 5, 7, 9, 5, 5, 8, 5 ],
	[ 5, 9, 5, 7, 5, 9, 5, 5, 5, 5, 5, 5, 5, 9, 9, 9 ],
	[ 5, 9, 5, 9, 5, 5, 8, 7, 7, 5, 5, 8, 9, 7, 5, 5 ]
],
"objects": [
	{
		"x": 1920,
		"y": 1248,
		"type": "HAUNTED_TREE"
	}
],
"lastModified": 1730175599426
}