{
"x": 3,
"y": 10,
"biomeType": "PLAINS",
"tileData": [
	[ 10, 1, 10, 1, 10, 1, 1, 1, 1, 1, 1, 1, 1, 1, 1, 1 ],
	[ 10, 10, 1, 1, 1, 1, 1, 1, 10, 10, 10, 1, 1, 1, 1, 1 ],
	[ 1, 1, 1, 1, 1, 10, 1, 10, 1, 10, 10, 1, 10, 10, 1, 10 ],
	[ 1, 10, 1, 10, 10, 1, 1, 10, 1, 1, 1, 1, 10, 1, 1, 10 ],
	[ 1, 1, 1, 1, 10, 1, 1, 1, 1, 1, 1, 1, 1, 1, 1, 1 ],
	[ 10, 10, 1, 1, 1, 10, 1, 1, 1, 10, 10, 10, 1, 1, 1, 1 ],
	[ 10, 1, 10, 1, 1, 1, 10, 1, 10, 1, 1, 1, 1, 1, 1, 1 ],
	[ 1, 1, 1, 1, 1, 10, 1, 1, 1, 1, 1, 1, 10, 10, 1, 1 ],
	[ 1, 10, 1, 1, 1, 1, 1, 1, 1, 1, 1, 1, 1, 1, 1, 1 ],
	[ 1, 1, 1, 1, 1, 1, 1, 1, 1, 10, 1, 1, 10, 1, 1, 10 ],
	[ 1, 1, 10, 1, 1, 10, 1, 1, 1, 1, 10, 1, 1, 10, 1, 10 ],
	[ 10, 10, 1, 10, 1, 1, 1, 1, 10, 1, 10, 10, 1, 1, 1, 1 ],
	[ 1, 1, 1, 1, 1, 1, 1, 1, 10, 1, 1, 1, 1, 1, 10, 1 ],
	[ 1, 1, 1, 1, 1, 1, 1, 1, 1, 1, 1, 1, 10, 1, 1, 1 ],
	[ 10, 1, 1, 1, 1, 1, 1, 1, 1, 1, 1, 1, 1, 1, 1, 1 ],
	[ 1, 1, 1, 10, 1, 10, 10, 1, 1, 10, 1, 1, 1, 10, 10, 1 ]
],
"objects": [
	{
		"x": 1728,
		"y": 5248,
		"type": "TREE"
	},
	{
		"x": 1792,
		"y": 5184,
		"type": "TREE"
	}
],
"lastModified": 1730175620445
}