{
"x": -2,
"y": 7,
"biomeType": "HAUNTED",
"tileData": [
	[ 7, 5, 8, 5, 5, 8, 5, 5, 5, 5, 9, 5, 5, 9, 5, 5 ],
	[ 9, 9, 5, 5, 9, 5, 5, 9, 5, 5, 5, 5, 5, 9, 9, 5 ],
	[ 9, 5, 9, 5, 5, 9, 5, 5, 5, 9, 9, 7, 5, 5, 5, 5 ],
	[ 5, 5, 5, 5, 5, 5, 5, 9, 5, 5, 7, 9, 7, 5, 5, 9 ],
	[ 9, 5, 5, 5, 9, 5, 5, 5, 7, 5, 9, 5, 5, 9, 5, 7 ],
	[ 5, 5, 5, 5, 8, 7, 5, 9, 5, 9, 5, 9, 5, 7, 7, 5 ],
	[ 5, 7, 5, 5, 5, 5, 9, 5, 5, 5, 7, 9, 5, 5, 5, 7 ],
	[ 7, 9, 5, 5, 5, 5, 9, 7, 5, 7, 5, 9, 9, 5, 5, 5 ],
	[ 5, 5, 5, 9, 5, 5, 5, 9, 7, 5, 5, 9, 9, 7, 5, 5 ],
	[ 5, 9, 5, 5, 5, 5, 5, 5, 7, 5, 5, 5, 5, 5, 8, 9 ],
	[ 8, 9, 5, 5, 5, 5, 5, 5, 5, 5, 9, 8, 5, 5, 5, 5 ],
	[ 7, 9, 5, 5, 7, 5, 5, 5, 7, 7, 5, 5, 5, 9, 8, 5 ],
	[ 5, 5, 9, 5, 8, 9, 7, 5, 5, 8, 5, 7, 7, 5, 9, 5 ],
	[ 7, 5, 5, 5, 5, 5, 9, 5, 5, 5, 5, 5, 9, 7, 5, 7 ],
	[ 5, 5, 5, 5, 5, 9, 5, 5, 5, 5, 9, 5, 5, 7, 5, 8 ],
	[ 9, 9, 5, 9, 9, 8, 5, 5, 9, 7, 5, 7, 5, 5, 5, 5 ]
],
"lastModified": 1730208107995
}