{
"y": 7,
"biomeType": "PLAINS",
"tileData": [
	[ 1, 1, 1, 10, 1, 1, 1, 1, 1, 1, 10, 1, 1, 10, 1, 1 ],
	[ 1, 1, 1, 1, 1, 1, 10, 1, 10, 10, 1, 10, 1, 10, 1, 1 ],
	[ 10, 10, 10, 1, 1, 1, 1, 10, 1, 10, 1, 1, 1, 1, 1, 1 ],
	[ 1, 1, 1, 1, 1, 1, 10, 1, 10, 1, 1, 10, 1, 1, 1, 1 ],
	[ 1, 1, 1, 1, 1, 10, 1, 1, 1, 1, 1, 1, 1, 1, 1, 1 ],
	[ 1, 1, 10, 1, 1, 1, 10, 10, 1, 1, 1, 10, 1, 10, 1, 1 ],
	[ 1, 1, 1, 1, 1, 1, 1, 10, 1, 1, 1, 1, 10, 1, 1, 10 ],
	[ 10, 1, 10, 1, 1, 1, 1, 10, 1, 1, 1, 10, 10, 1, 1, 1 ],
	[ 1, 1, 1, 1, 10, 1, 1, 1, 10, 1, 10, 1, 1, 1, 1, 1 ],
	[ 10, 1, 1, 10, 1, 1, 1, 1, 1, 10, 1, 10, 1, 10, 1, 1 ],
	[ 1, 1, 10, 1, 1, 10, 1, 1, 1, 10, 1, 10, 1, 1, 1, 1 ],
	[ 10, 1, 1, 1, 1, 1, 1, 1, 1, 10, 1, 1, 1, 1, 1, 10 ],
	[ 10, 1, 1, 1, 1, 1, 1, 1, 1, 10, 1, 1, 1, 1, 1, 1 ],
	[ 1, 1, 1, 1, 1, 1, 1, 1, 1, 1, 1, 1, 1, 1, 1, 1 ],
	[ 1, 1, 1, 1, 10, 1, 1, 10, 1, 1, 10, 10, 1, 1, 1, 1 ],
	[ 1, 1, 1, 1, 10, 1, 1, 10, 1, 1, 10, 1, 10, 1, 1, 1 ]
],
"objects": [
	{
		"x": 128,
		"y": 3808,
		"type": "TREE"
	}
],
"lastModified": 1730175592856
}