{
"x": 2,
"y": 9,
"biomeType": "PLAINS",
"tileData": [
	[ 1, 1, 1, 1, 1, 1, 1, 1, 1, 1, 10, 10, 1, 1, 1, 1 ],
	[ 1, 1, 1, 1, 1, 1, 1, 10, 1, 1, 1, 1, 1, 10, 1, 10 ],
	[ 1, 1, 10, 1, 1, 1, 10, 1, 1, 1, 1, 10, 1, 1, 1, 1 ],
	[ 1, 1, 1, 1, 1, 1, 10, 1, 1, 1, 1, 10, 1, 1, 1, 1 ],
	[ 1, 10, 1, 1, 1, 1, 10, 1, 1, 1, 1, 1, 10, 10, 1, 1 ],
	[ 1, 1, 1, 1, 1, 1, 1, 1, 1, 1, 1, 1, 1, 1, 1, 1 ],
	[ 1, 10, 10, 10, 10, 1, 1, 1, 10, 1, 1, 10, 1, 1, 10, 1 ],
	[ 1, 1, 1, 1, 1, 1, 1, 10, 1, 10, 1, 1, 10, 1, 1, 1 ],
	[ 1, 1, 1, 1, 1, 1, 1, 1, 1, 1, 1, 1, 1, 10, 1, 1 ],
	[ 1, 10, 1, 1, 1, 1, 1, 10, 1, 1, 1, 1, 1, 1, 10, 1 ],
	[ 1, 1, 1, 1, 1, 1, 1, 1, 10, 1, 1, 1, 10, 1, 1, 1 ],
	[ 1, 1, 1, 1, 1, 1, 10, 1, 1, 1, 1, 1, 1, 1, 10, 1 ],
	[ 10, 1, 1, 1, 10, 1, 1, 10, 1, 1, 10, 1, 1, 1, 1, 1 ],
	[ 10, 10, 10, 1, 1, 10, 1, 1, 10, 1, 1, 1, 10, 1, 10, 1 ],
	[ 1, 10, 1, 1, 10, 1, 10, 10, 1, 1, 1, 1, 1, 1, 1, 1 ],
	[ 1, 1, 1, 1, 1, 10, 10, 10, 1, 1, 1, 10, 1, 10, 1, 1 ]
],
"lastModified": 1730175599423
}