{
"x": 6,
"y": 9,
"biomeType": "PLAINS",
"tileData": [
	[ 1, 1, 1, 1, 1, 1, 1, 1, 10, 10, 1, 1, 1, 1, 10, 1 ],
	[ 1, 10, 10, 1, 1, 1, 1, 1, 1, 1, 1, 10, 1, 1, 10, 10 ],
	[ 1, 10, 1, 1, 1, 1, 1, 1, 1, 1, 1, 10, 1, 1, 1, 10 ],
	[ 10, 1, 1, 1, 1, 1, 10, 1, 1, 1, 1, 10, 10, 1, 1, 1 ],
	[ 1, 10, 1, 1, 1, 1, 1, 1, 10, 1, 1, 1, 10, 1, 1, 1 ],
	[ 1, 1, 1, 10, 1, 10, 1, 1, 1, 1, 1, 1, 1, 1, 1, 1 ],
	[ 1, 1, 10, 1, 1, 1, 1, 1, 1, 1, 10, 1, 1, 1, 10, 1 ],
	[ 1, 1, 10, 1, 1, 1, 1, 1, 1, 1, 10, 1, 1, 1, 10, 1 ],
	[ 1, 1, 1, 1, 1, 1, 1, 1, 1, 1, 1, 1, 1, 1, 1, 1 ],
	[ 1, 1, 1, 1, 1, 10, 10, 1, 1, 1, 1, 1, 1, 1, 1, 1 ],
	[ 1, 10, 10, 1, 1, 1, 10, 1, 1, 1, 1, 1, 1, 1, 10, 1 ],
	[ 1, 1, 1, 10, 10, 1, 1, 1, 1, 1, 1, 1, 1, 1, 10, 10 ],
	[ 1, 10, 1, 1, 1, 1, 1, 1, 1, 1, 1, 1, 10, 1, 10, 1 ],
	[ 1, 1, 1, 1, 1, 1, 1, 1, 1, 1, 1, 1, 1, 1, 1, 1 ],
	[ 1, 10, 1, 1, 10, 1, 1, 1, 10, 1, 1, 1, 10, 1, 1, 1 ],
	[ 1, 1, 1, 1, 1, 1, 1, 1, 10, 1, 10, 1, 10, 1, 10, 1 ]
],
"objects": [
	{
		"x": 3424,
		"y": 4768,
		"type": "TREE"
	}
],
"lastModified": 1730248837778
}