{
"x": -1,
"y": 5,
"biomeType": "HAUNTED",
"tileData": [
	[ 9, 9, 5, 5, 5, 5, 8, 5, 5, 5, 5, 5, 5, 5, 5, 5 ],
	[ 9, 5, 5, 9, 9, 5, 5, 9, 8, 5, 7, 5, 5, 5, 5, 7 ],
	[ 9, 5, 7, 5, 5, 5, 5, 5, 8, 5, 8, 9, 5, 5, 5, 5 ],
	[ 5, 7, 8, 5, 5, 5, 5, 5, 7, 9, 5, 9, 9, 5, 5, 5 ],
	[ 5, 5, 7, 7, 9, 5, 9, 5, 9, 7, 5, 5, 5, 5, 5, 5 ],
	[ 5, 7, 7, 5, 9, 5, 5, 9, 8, 8, 5, 5, 7, 5, 5, 5 ],
	[ 5, 5, 5, 5, 5, 5, 5, 5, 5, 9, 5, 5, 7, 5, 7, 5 ],
	[ 5, 5, 5, 5, 5, 5, 5, 7, 9, 5, 5, 5, 5, 7, 5, 5 ],
	[ 9, 9, 5, 7, 5, 9, 8, 5, 9, 9, 7, 5, 5, 7, 7, 9 ],
	[ 9, 5, 5, 5, 5, 5, 9, 5, 5, 5, 5, 8, 9, 9, 9, 5 ],
	[ 5, 5, 9, 8, 9, 5, 5, 7, 5, 7, 7, 9, 8, 5, 5, 5 ],
	[ 8, 7, 5, 5, 5, 5, 8, 5, 7, 9, 7, 9, 5, 7, 5, 5 ],
	[ 5, 9, 5, 5, 5, 5, 7, 5, 9, 5, 5, 7, 7, 5, 7, 9 ],
	[ 5, 5, 9, 9, 5, 9, 5, 5, 9, 5, 5, 5, 7, 5, 5, 5 ],
	[ 5, 5, 5, 5, 5, 7, 5, 5, 5, 5, 9, 9, 9, 5, 9, 9 ],
	[ 5, 8, 5, 5, 5, 5, 9, 5, 5, 9, 5, 7, 5, 7, 5, 9 ]
],
"objects": [
	{
		"x": -352,
		"y": 2784,
		"type": "HAUNTED_TREE"
	}
],
"lastModified": 1730175588110
}