{
"x": 1,
"y": 9,
"biomeType": "PLAINS",
"tileData": [
	[ 1, 10, 1, 10, 1, 10, 10, 10, 1, 1, 1, 1, 1, 1, 10, 1 ],
	[ 10, 10, 1, 1, 10, 1, 1, 1, 1, 1, 1, 1, 1, 1, 1, 1 ],
	[ 1, 1, 1, 1, 10, 10, 1, 1, 10, 10, 10, 1, 1, 1, 1, 1 ],
	[ 1, 10, 1, 10, 1, 1, 1, 1, 1, 1, 1, 1, 1, 1, 1, 1 ],
	[ 1, 1, 1, 1, 1, 1, 10, 1, 1, 1, 1, 1, 1, 10, 1, 10 ],
	[ 10, 1, 1, 1, 1, 1, 10, 1, 10, 10, 1, 1, 1, 10, 1, 1 ],
	[ 1, 10, 1, 1, 1, 1, 1, 10, 1, 1, 10, 1, 1, 1, 10, 1 ],
	[ 10, 10, 1, 1, 1, 1, 1, 1, 10, 1, 1, 1, 1, 1, 10, 1 ],
	[ 1, 1, 10, 1, 1, 1, 1, 1, 1, 1, 1, 1, 1, 10, 1, 1 ],
	[ 1, 1, 1, 1, 1, 10, 10, 1, 10, 10, 1, 1, 10, 1, 1, 1 ],
	[ 1, 10, 1, 10, 1, 1, 1, 1, 1, 10, 10, 1, 10, 1, 1, 1 ],
	[ 10, 1, 10, 1, 10, 1, 1, 1, 10, 1, 10, 1, 1, 1, 1, 1 ],
	[ 1, 1, 1, 1, 10, 1, 1, 1, 10, 10, 1, 1, 1, 1, 1, 1 ],
	[ 1, 1, 1, 1, 1, 1, 1, 1, 1, 1, 1, 1, 10, 10, 1, 1 ],
	[ 1, 1, 1, 1, 1, 1, 1, 1, 1, 1, 1, 1, 1, 1, 1, 10 ],
	[ 10, 1, 1, 10, 10, 1, 1, 1, 1, 1, 1, 1, 1, 10, 1, 1 ]
],
"objects": [
	{
		"x": 736,
		"y": 4960,
		"type": "TREE"
	}
],
"lastModified": 1730175599422
}