{
"x": 1,
"y": 6,
"biomeType": "PLAINS",
"tileData": [
	[ 10, 1, 1, 1, 1, 1, 1, 1, 1, 1, 1, 10, 10, 1, 1, 1 ],
	[ 1, 1, 1, 1, 1, 1, 1, 10, 1, 10, 1, 1, 1, 1, 1, 1 ],
	[ 1, 1, 1, 1, 1, 1, 10, 1, 1, 1, 1, 1, 10, 1, 1, 1 ],
	[ 1, 1, 10, 1, 1, 10, 10, 1, 1, 1, 1, 1, 1, 1, 1, 1 ],
	[ 1, 1, 1, 1, 1, 1, 1, 1, 10, 10, 1, 1, 1, 1, 1, 10 ],
	[ 10, 1, 1, 1, 1, 10, 1, 10, 10, 1, 1, 1, 1, 1, 1, 1 ],
	[ 1, 1, 1, 10, 1, 1, 1, 1, 1, 10, 10, 10, 1, 1, 1, 1 ],
	[ 10, 1, 1, 10, 1, 1, 10, 10, 10, 1, 10, 1, 1, 1, 10, 1 ],
	[ 1, 1, 10, 1, 1, 10, 1, 1, 1, 1, 1, 1, 10, 1, 1, 1 ],
	[ 1, 1, 1, 10, 1, 1, 1, 1, 1, 10, 1, 1, 1, 1, 1, 1 ],
	[ 1, 1, 1, 1, 10, 10, 1, 10, 1, 1, 1, 1, 1, 1, 1, 1 ],
	[ 1, 1, 1, 1, 10, 1, 1, 1, 1, 1, 1, 1, 1, 1, 1, 1 ],
	[ 10, 1, 1, 1, 1, 10, 1, 1, 1, 1, 10, 10, 1, 1, 1, 10 ],
	[ 1, 1, 1, 1, 10, 1, 1, 1, 1, 1, 1, 10, 1, 1, 1, 10 ],
	[ 1, 1, 1, 1, 1, 1, 1, 1, 1, 1, 1, 1, 1, 1, 1, 10 ],
	[ 10, 1, 1, 1, 10, 1, 1, 1, 10, 1, 1, 1, 1, 1, 1, 1 ]
],
"lastModified": 1730175590943
}