{
"y": 10,
"biomeType": "PLAINS",
"tileData": [
	[ 1, 1, 1, 10, 1, 10, 1, 1, 1, 10, 1, 1, 1, 1, 1, 1 ],
	[ 1, 1, 1, 10, 1, 1, 10, 1, 1, 1, 10, 10, 10, 1, 10, 1 ],
	[ 1, 1, 1, 10, 1, 10, 1, 10, 10, 1, 1, 1, 1, 10, 1, 1 ],
	[ 1, 1, 1, 1, 1, 1, 10, 10, 10, 10, 1, 1, 1, 1, 1, 1 ],
	[ 1, 10, 10, 10, 1, 10, 10, 10, 1, 1, 1, 1, 1, 1, 10, 1 ],
	[ 1, 1, 1, 1, 1, 1, 1, 1, 1, 1, 1, 1, 1, 10, 1, 1 ],
	[ 1, 1, 1, 1, 1, 1, 1, 1, 1, 1, 1, 10, 1, 1, 1, 1 ],
	[ 1, 1, 1, 1, 1, 1, 1, 1, 1, 1, 1, 1, 1, 10, 10, 10 ],
	[ 10, 1, 10, 1, 1, 1, 1, 1, 1, 1, 10, 1, 1, 10, 1, 1 ],
	[ 1, 1, 1, 1, 10, 1, 10, 1, 1, 10, 10, 1, 1, 1, 1, 1 ],
	[ 1, 1, 1, 1, 1, 1, 1, 1, 1, 1, 1, 1, 1, 1, 10, 1 ],
	[ 1, 1, 1, 1, 1, 1, 10, 1, 1, 1, 1, 1, 1, 1, 1, 1 ],
	[ 1, 1, 10, 1, 1, 1, 1, 1, 1, 1, 1, 1, 10, 1, 1, 1 ],
	[ 1, 1, 1, 1, 1, 10, 1, 1, 10, 10, 1, 10, 10, 10, 10, 10 ],
	[ 10, 1, 1, 10, 1, 1, 1, 1, 1, 10, 1, 1, 1, 1, 1, 10 ],
	[ 1, 1, 1, 1, 10, 1, 1, 1, 1, 1, 1, 1, 10, 1, 1, 1 ]
],
"objects": [
	{
		"x": 128,
		"y": 5472,
		"type": "TREE"
	},
	{
		"x": 192,
		"y": 5312,
		"type": "TREE"
	}
],
"lastModified": 1730175620442
}