{
"x": -2,
"y": 2,
"biomeType": "HAUNTED",
"tileData": [
	[ 9, 7, 7, 5, 5, 5, 5, 5, 7, 5, 5, 7, 5, 5, 5, 5 ],
	[ 5, 5, 5, 5, 5, 9, 7, 7, 9, 5, 7, 5, 5, 7, 9, 5 ],
	[ 7, 5, 5, 5, 9, 5, 9, 5, 7, 5, 7, 5, 9, 7, 5, 5 ],
	[ 7, 5, 5, 5, 9, 5, 5, 9, 9, 5, 5, 9, 9, 9, 7, 5 ],
	[ 9, 5, 5, 5, 5, 7, 5, 9, 5, 9, 5, 7, 9, 8, 9, 5 ],
	[ 7, 5, 9, 5, 9, 5, 9, 9, 5, 5, 5, 5, 7, 5, 5, 7 ],
	[ 5, 9, 7, 5, 5, 7, 5, 7, 9, 9, 5, 5, 9, 8, 5, 5 ],
	[ 5, 9, 5, 5, 5, 5, 5, 5, 7, 7, 5, 5, 5, 7, 9, 7 ],
	[ 5, 5, 5, 9, 5, 5, 9, 7, 5, 7, 5, 7, 8, 5, 5, 5 ],
	[ 5, 7, 5, 7, 7, 8, 5, 5, 5, 5, 7, 7, 5, 5, 5, 5 ],
	[ 5, 9, 7, 7, 5, 7, 5, 5, 5, 5, 5, 5, 5, 8, 5, 5 ],
	[ 5, 5, 7, 5, 7, 5, 5, 5, 5, 5, 5, 5, 5, 5, 5, 5 ],
	[ 5, 7, 9, 9, 5, 5, 8, 7, 7, 5, 5, 5, 5, 5, 5, 5 ],
	[ 5, 5, 9, 5, 5, 9, 5, 9, 5, 9, 5, 9, 5, 9, 5, 5 ],
	[ 5, 7, 8, 5, 5, 5, 8, 9, 9, 5, 5, 9, 5, 5, 5, 7 ],
	[ 9, 9, 5, 9, 9, 5, 5, 9, 5, 9, 7, 5, 8, 7, 5, 5 ]
],
"objects": [
	{
		"x": -960,
		"y": 1120,
		"type": "HAUNTED_TREE"
	},
	{
		"x": -800,
		"y": 1088,
		"type": "HAUNTED_TREE"
	}
],
"lastModified": 1730175599429
}