{
"x": 7,
"y": 12,
"biomeType": "PLAINS",
"tileData": [
	[ 1, 10, 1, 1, 1, 1, 1, 1, 10, 1, 1, 1, 1, 1, 1, 10 ],
	[ 1, 1, 1, 1, 1, 1, 1, 1, 1, 1, 1, 10, 10, 1, 10, 1 ],
	[ 1, 1, 1, 10, 1, 1, 1, 1, 1, 1, 10, 1, 1, 1, 1, 1 ],
	[ 1, 1, 1, 10, 10, 1, 1, 1, 1, 1, 1, 1, 10, 1, 10, 1 ],
	[ 1, 1, 1, 10, 1, 10, 1, 10, 1, 1, 1, 1, 1, 1, 1, 1 ],
	[ 10, 1, 1, 1, 1, 10, 1, 1, 1, 1, 1, 1, 1, 1, 1, 1 ],
	[ 1, 1, 1, 1, 1, 1, 1, 10, 1, 10, 10, 1, 1, 1, 1, 1 ],
	[ 1, 1, 10, 1, 1, 1, 10, 10, 1, 1, 1, 10, 1, 1, 1, 1 ],
	[ 1, 1, 10, 1, 1, 1, 1, 1, 1, 1, 10, 1, 1, 1, 1, 1 ],
	[ 1, 1, 10, 1, 1, 1, 1, 1, 1, 10, 1, 1, 1, 10, 1, 1 ],
	[ 1, 1, 1, 1, 1, 1, 1, 10, 1, 1, 10, 1, 1, 1, 1, 1 ],
	[ 1, 1, 1, 1, 1, 1, 1, 1, 1, 1, 10, 10, 1, 1, 10, 10 ],
	[ 1, 1, 10, 1, 1, 10, 1, 1, 1, 1, 1, 1, 10, 1, 1, 1 ],
	[ 1, 1, 10, 1, 1, 1, 1, 10, 1, 1, 1, 1, 10, 1, 10, 1 ],
	[ 1, 1, 1, 10, 1, 1, 1, 1, 1, 10, 1, 1, 1, 1, 10, 1 ],
	[ 1, 1, 1, 1, 1, 10, 1, 1, 1, 1, 1, 1, 1, 1, 1, 10 ]
],
"objects": [
	{
		"x": 3840,
		"y": 6400,
		"type": "TREE"
	}
],
"lastModified": 1730249048273
}