{
"x": -1,
"y": -1,
"biomeType": "HAUNTED",
"tileData": [
	[ 5, 5, 5, 5, 5, 5, 5, 9, 5, 5, 5, 7, 5, 5, 5, 5 ],
	[ 5, 8, 5, 5, 9, 5, 5, 5, 8, 5, 5, 5, 5, 7, 5, 5 ],
	[ 7, 9, 5, 5, 5, 5, 9, 5, 7, 5, 5, 5, 5, 5, 5, 5 ],
	[ 5, 5, 7, 5, 5, 5, 5, 7, 5, 5, 5, 5, 5, 9, 5, 8 ],
	[ 5, 9, 9, 5, 5, 9, 9, 9, 5, 5, 8, 9, 5, 5, 5, 9 ],
	[ 9, 9, 7, 9, 5, 5, 5, 5, 9, 5, 5, 5, 5, 5, 5, 8 ],
	[ 5, 5, 5, 5, 9, 5, 9, 5, 5, 5, 5, 7, 5, 5, 5, 5 ],
	[ 5, 5, 5, 5, 7, 8, 5, 5, 9, 9, 9, 5, 5, 5, 7, 5 ],
	[ 9, 7, 5, 9, 5, 5, 7, 9, 9, 7, 5, 5, 9, 5, 5, 5 ],
	[ 5, 5, 5, 9, 5, 9, 9, 8, 5, 5, 9, 5, 5, 7, 5, 5 ],
	[ 5, 9, 5, 5, 5, 5, 7, 5, 5, 5, 5, 5, 5, 8, 5, 5 ],
	[ 5, 7, 5, 5, 9, 7, 5, 8, 5, 9, 5, 9, 5, 7, 5, 5 ],
	[ 5, 5, 9, 5, 5, 5, 5, 5, 5, 5, 5, 5, 5, 5, 5, 5 ],
	[ 9, 9, 9, 5, 5, 5, 9, 5, 9, 5, 5, 5, 5, 5, 5, 7 ],
	[ 5, 9, 5, 7, 5, 8, 5, 5, 8, 5, 5, 5, 5, 9, 5, 5 ],
	[ 7, 5, 9, 9, 9, 5, 5, 5, 5, 9, 9, 5, 9, 9, 7, 5 ]
],
"objects": [
	{
		"x": -352,
		"y": -160,
		"type": "HAUNTED_TREE"
	},
	{
		"x": -128,
		"y": -352,
		"type": "HAUNTED_TREE"
	}
],
"lastModified": 1730175585559
}