{
"x": -2,
"y": 4,
"biomeType": "HAUNTED",
"tileData": [
	[ 5, 7, 9, 5, 9, 5, 5, 9, 9, 5, 5, 5, 9, 9, 5, 7 ],
	[ 5, 5, 5, 5, 7, 9, 5, 5, 9, 5, 7, 5, 5, 5, 5, 5 ],
	[ 5, 5, 5, 9, 9, 5, 5, 5, 5, 5, 5, 9, 9, 9, 5, 5 ],
	[ 7, 5, 5, 9, 5, 9, 5, 9, 5, 5, 5, 5, 5, 5, 9, 5 ],
	[ 5, 9, 5, 5, 5, 5, 5, 5, 5, 5, 9, 5, 5, 5, 9, 9 ],
	[ 5, 5, 5, 9, 5, 9, 5, 5, 9, 7, 9, 9, 8, 9, 5, 5 ],
	[ 5, 7, 5, 5, 5, 5, 5, 5, 5, 9, 9, 9, 5, 7, 5, 5 ],
	[ 9, 7, 5, 5, 9, 5, 5, 5, 7, 5, 5, 7, 5, 5, 7, 5 ],
	[ 5, 7, 5, 9, 5, 5, 5, 5, 9, 5, 5, 5, 5, 7, 5, 5 ],
	[ 7, 9, 5, 5, 9, 5, 9, 9, 9, 7, 5, 9, 9, 5, 5, 9 ],
	[ 9, 5, 5, 9, 5, 8, 9, 5, 7, 5, 5, 7, 9, 5, 5, 5 ],
	[ 9, 7, 9, 5, 5, 7, 5, 7, 7, 5, 9, 5, 5, 5, 5, 9 ],
	[ 5, 9, 5, 5, 7, 5, 5, 5, 5, 5, 5, 5, 7, 9, 5, 5 ],
	[ 5, 9, 9, 8, 9, 5, 9, 9, 9, 7, 5, 9, 9, 5, 7, 5 ],
	[ 9, 5, 5, 5, 5, 5, 5, 9, 7, 9, 5, 5, 5, 7, 7, 8 ],
	[ 5, 5, 5, 5, 5, 7, 5, 9, 5, 5, 7, 9, 7, 5, 7, 5 ]
],
"objects": [
	{
		"x": -768,
		"y": 2368,
		"type": "HAUNTED_TREE"
	}
],
"lastModified": 1730175631727
}