{
"x": 5,
"y": 10,
"biomeType": "PLAINS",
"tileData": [
	[ 1, 10, 10, 1, 1, 1, 10, 1, 1, 1, 10, 1, 1, 1, 1, 1 ],
	[ 1, 1, 1, 1, 1, 1, 1, 1, 1, 1, 1, 10, 10, 10, 1, 1 ],
	[ 1, 1, 1, 10, 1, 1, 1, 1, 1, 1, 1, 1, 10, 10, 1, 1 ],
	[ 1, 10, 10, 1, 10, 1, 1, 1, 1, 10, 1, 1, 10, 1, 1, 1 ],
	[ 1, 1, 10, 1, 1, 1, 1, 10, 1, 10, 1, 1, 10, 10, 1, 1 ],
	[ 1, 1, 10, 1, 1, 1, 1, 1, 1, 1, 1, 1, 1, 10, 1, 1 ],
	[ 1, 10, 1, 1, 1, 1, 1, 1, 1, 10, 1, 1, 1, 10, 1, 10 ],
	[ 1, 1, 1, 10, 1, 1, 10, 1, 1, 1, 1, 1, 1, 10, 1, 1 ],
	[ 1, 1, 1, 10, 10, 1, 1, 10, 1, 1, 1, 1, 1, 10, 1, 1 ],
	[ 1, 1, 1, 1, 1, 10, 1, 1, 10, 1, 1, 1, 1, 10, 1, 1 ],
	[ 10, 1, 1, 1, 1, 1, 1, 1, 10, 1, 1, 1, 10, 1, 1, 10 ],
	[ 1, 10, 1, 1, 1, 1, 1, 1, 10, 10, 1, 1, 10, 1, 1, 1 ],
	[ 10, 10, 10, 1, 10, 10, 1, 1, 10, 1, 1, 1, 1, 1, 1, 1 ],
	[ 1, 10, 10, 1, 1, 1, 10, 10, 1, 10, 10, 1, 1, 1, 1, 10 ],
	[ 10, 1, 1, 1, 1, 1, 1, 1, 1, 1, 1, 1, 1, 1, 1, 1 ],
	[ 1, 1, 10, 10, 1, 10, 10, 1, 1, 1, 1, 1, 1, 1, 1, 1 ]
],
"objects": [
	{
		"x": 2656,
		"y": 5216,
		"type": "TREE"
	}
],
"lastModified": 1730175624411
}