{
"x": -1,
"y": 6,
"biomeType": "HAUNTED",
"tileData": [
	[ 5, 9, 5, 9, 5, 5, 5, 9, 5, 5, 5, 5, 5, 9, 5, 7 ],
	[ 5, 5, 7, 5, 9, 9, 5, 9, 5, 5, 5, 5, 5, 5, 8, 5 ],
	[ 5, 5, 5, 5, 5, 9, 9, 9, 5, 5, 9, 9, 7, 5, 9, 7 ],
	[ 5, 7, 5, 5, 5, 5, 8, 5, 9, 9, 5, 5, 8, 5, 5, 5 ],
	[ 9, 7, 5, 7, 5, 9, 5, 7, 9, 5, 5, 9, 5, 5, 5, 7 ],
	[ 5, 5, 9, 8, 5, 5, 9, 5, 5, 5, 5, 5, 9, 8, 9, 5 ],
	[ 8, 5, 7, 7, 5, 9, 9, 8, 7, 5, 9, 5, 5, 5, 5, 5 ],
	[ 5, 9, 5, 5, 5, 5, 5, 7, 5, 5, 7, 5, 5, 9, 9, 5 ],
	[ 7, 5, 5, 5, 9, 5, 9, 5, 9, 7, 7, 5, 5, 5, 5, 5 ],
	[ 5, 5, 9, 5, 5, 9, 9, 5, 5, 5, 5, 7, 5, 5, 5, 5 ],
	[ 8, 7, 7, 7, 5, 5, 5, 9, 5, 5, 7, 5, 9, 5, 5, 9 ],
	[ 5, 7, 5, 5, 9, 5, 5, 5, 5, 5, 9, 7, 5, 5, 5, 9 ],
	[ 5, 8, 7, 5, 9, 9, 5, 8, 5, 5, 9, 5, 5, 9, 5, 5 ],
	[ 5, 9, 7, 5, 9, 5, 5, 5, 5, 5, 5, 9, 5, 5, 7, 7 ],
	[ 5, 5, 5, 5, 9, 5, 5, 5, 5, 8, 7, 5, 5, 5, 5, 9 ],
	[ 5, 7, 9, 5, 5, 5, 5, 5, 5, 5, 5, 5, 5, 5, 9, 7 ]
],
"objects": [
	{
		"x": -352,
		"y": 3360,
		"type": "HAUNTED_TREE"
	},
	{
		"x": -320,
		"y": 3232,
		"type": "HAUNTED_TREE"
	}
],
"lastModified": 1730175590941
}