{
"x": 4,
"y": 10,
"biomeType": "PLAINS",
"tileData": [
	[ 10, 1, 1, 1, 1, 1, 1, 10, 1, 1, 1, 1, 10, 1, 10, 1 ],
	[ 1, 1, 1, 10, 1, 1, 1, 1, 10, 10, 1, 1, 1, 1, 1, 1 ],
	[ 1, 1, 1, 1, 10, 1, 1, 10, 1, 1, 1, 1, 1, 1, 1, 1 ],
	[ 1, 1, 1, 10, 10, 1, 1, 1, 1, 1, 10, 1, 10, 1, 1, 10 ],
	[ 10, 10, 10, 1, 10, 1, 1, 1, 10, 1, 1, 10, 1, 1, 1, 1 ],
	[ 1, 1, 1, 1, 1, 1, 1, 10, 10, 1, 1, 10, 1, 1, 1, 1 ],
	[ 1, 1, 1, 1, 1, 1, 1, 1, 1, 10, 1, 1, 1, 1, 1, 1 ],
	[ 1, 1, 10, 1, 1, 10, 10, 1, 1, 1, 1, 1, 1, 1, 1, 10 ],
	[ 1, 10, 1, 1, 1, 1, 10, 1, 1, 1, 1, 1, 1, 10, 1, 1 ],
	[ 1, 1, 1, 1, 1, 1, 1, 1, 1, 1, 1, 1, 1, 1, 1, 10 ],
	[ 1, 1, 1, 1, 1, 1, 10, 1, 10, 1, 1, 1, 1, 1, 10, 1 ],
	[ 1, 1, 1, 1, 1, 1, 10, 1, 1, 1, 10, 1, 10, 1, 1, 1 ],
	[ 1, 1, 1, 10, 1, 10, 1, 1, 1, 1, 1, 10, 1, 1, 1, 1 ],
	[ 1, 1, 1, 1, 1, 1, 1, 1, 1, 1, 1, 1, 1, 1, 10, 1 ],
	[ 1, 1, 10, 1, 1, 1, 1, 1, 1, 1, 1, 1, 1, 10, 10, 1 ],
	[ 10, 1, 1, 1, 1, 1, 1, 1, 1, 10, 1, 1, 1, 1, 1, 1 ]
],
"objects": [
	{
		"x": 2336,
		"y": 5440,
		"type": "POKEBALL"
	},
	{
		"x": 2432,
		"y": 5248,
		"type": "POKEBALL"
	},
	{
		"x": 2368,
		"y": 5344,
		"type": "POKEBALL"
	},
	{
		"x": 2304,
		"y": 5376,
		"type": "POKEBALL"
	},
	{
		"x": 2336,
		"y": 5504,
		"type": "POKEBALL"
	},
	{
		"x": 2144,
		"y": 5120,
		"type": "POKEBALL"
	},
	{
		"x": 2528,
		"y": 5152,
		"type": "POKEBALL"
	},
	{
		"x": 2208,
		"y": 5536,
		"type": "POKEBALL"
	},
	{
		"x": 2528,
		"y": 5600,
		"type": "POKEBALL"
	}
],
"lastModified": 1730208108000
}