{
"x": -1,
"y": 10,
"biomeType": "PLAINS",
"tileData": [
	[ 10, 1, 1, 1, 1, 10, 1, 1, 1, 1, 10, 1, 1, 10, 1, 10 ],
	[ 1, 1, 1, 1, 10, 1, 1, 1, 1, 1, 1, 1, 10, 1, 1, 1 ],
	[ 1, 1, 10, 1, 1, 1, 10, 1, 1, 1, 1, 10, 10, 1, 1, 1 ],
	[ 1, 1, 10, 1, 1, 1, 1, 1, 1, 1, 1, 1, 1, 10, 10, 1 ],
	[ 10, 1, 1, 1, 1, 1, 1, 1, 10, 1, 10, 1, 1, 1, 10, 1 ],
	[ 1, 1, 1, 1, 1, 1, 1, 1, 10, 1, 10, 10, 10, 10, 10, 1 ],
	[ 10, 10, 10, 1, 10, 1, 1, 1, 10, 10, 1, 1, 1, 10, 1, 1 ],
	[ 1, 10, 1, 1, 1, 1, 1, 1, 1, 1, 10, 10, 1, 1, 1, 1 ],
	[ 1, 1, 1, 10, 1, 1, 1, 1, 1, 10, 10, 1, 1, 1, 1, 1 ],
	[ 10, 1, 1, 1, 1, 1, 10, 1, 1, 1, 1, 1, 1, 1, 10, 1 ],
	[ 10, 10, 1, 1, 1, 1, 1, 1, 1, 1, 1, 10, 1, 1, 1, 1 ],
	[ 1, 1, 10, 10, 1, 1, 10, 1, 1, 1, 1, 1, 10, 1, 1, 10 ],
	[ 10, 10, 10, 1, 1, 1, 1, 1, 10, 1, 1, 10, 10, 1, 1, 1 ],
	[ 1, 10, 1, 1, 10, 10, 1, 1, 1, 1, 10, 1, 1, 1, 10, 1 ],
	[ 1, 1, 10, 1, 1, 1, 1, 1, 10, 1, 1, 10, 1, 1, 1, 1 ],
	[ 1, 1, 1, 1, 1, 1, 10, 1, 1, 1, 10, 1, 1, 1, 1, 10 ]
],
"objects": [
	{
		"x": -128,
		"y": 5408,
		"type": "TREE"
	}
],
"lastModified": 1730175620441
}