{
"x": -2,
"y": 10,
"biomeType": "PLAINS",
"tileData": [
	[ 1, 10, 10, 1, 1, 1, 1, 10, 1, 10, 10, 1, 1, 1, 1, 10 ],
	[ 1, 1, 1, 1, 1, 1, 1, 1, 1, 1, 10, 10, 1, 1, 1, 1 ],
	[ 1, 1, 1, 10, 1, 1, 1, 1, 1, 1, 1, 1, 1, 1, 1, 1 ],
	[ 1, 1, 1, 1, 10, 1, 10, 1, 1, 10, 10, 1, 1, 10, 1, 1 ],
	[ 1, 1, 1, 10, 1, 1, 10, 1, 1, 1, 1, 10, 1, 1, 1, 1 ],
	[ 10, 1, 1, 1, 1, 10, 1, 1, 1, 1, 1, 10, 1, 1, 1, 1 ],
	[ 1, 1, 10, 1, 10, 1, 1, 1, 1, 1, 1, 1, 1, 1, 1, 10 ],
	[ 1, 1, 1, 10, 10, 10, 1, 1, 1, 1, 10, 1, 1, 1, 1, 10 ],
	[ 1, 10, 10, 1, 1, 1, 1, 1, 1, 1, 10, 10, 1, 1, 1, 1 ],
	[ 1, 1, 1, 10, 1, 1, 1, 1, 1, 10, 1, 1, 10, 1, 10, 1 ],
	[ 1, 1, 1, 10, 10, 1, 1, 1, 1, 1, 1, 1, 10, 10, 1, 1 ],
	[ 1, 1, 1, 1, 10, 1, 1, 1, 1, 1, 1, 1, 10, 1, 1, 1 ],
	[ 1, 1, 1, 1, 1, 1, 1, 10, 1, 1, 1, 1, 1, 1, 1, 1 ],
	[ 10, 1, 1, 1, 1, 1, 1, 1, 10, 1, 1, 1, 1, 1, 1, 1 ],
	[ 1, 1, 1, 1, 1, 1, 1, 10, 1, 1, 1, 1, 10, 1, 10, 1 ],
	[ 10, 10, 1, 1, 10, 1, 1, 1, 10, 1, 1, 1, 1, 1, 10, 1 ]
],
"lastModified": 1730208107996
}