{
"x": 7,
"y": 9,
"biomeType": "PLAINS",
"tileData": [
	[ 10, 1, 10, 1, 1, 10, 1, 1, 1, 1, 1, 1, 10, 10, 10, 1 ],
	[ 1, 1, 1, 10, 1, 1, 1, 1, 1, 10, 1, 1, 1, 1, 1, 1 ],
	[ 1, 1, 1, 1, 1, 1, 1, 1, 1, 1, 10, 1, 1, 1, 1, 1 ],
	[ 1, 1, 1, 10, 1, 10, 10, 10, 1, 1, 1, 10, 1, 1, 10, 1 ],
	[ 1, 1, 1, 1, 1, 1, 1, 1, 1, 1, 1, 1, 1, 1, 10, 1 ],
	[ 1, 1, 10, 1, 1, 1, 1, 1, 1, 1, 1, 1, 1, 1, 1, 10 ],
	[ 10, 1, 1, 10, 1, 1, 1, 10, 1, 1, 1, 1, 1, 1, 1, 1 ],
	[ 1, 1, 1, 1, 10, 1, 1, 1, 1, 1, 1, 1, 1, 1, 1, 1 ],
	[ 1, 10, 1, 1, 1, 1, 1, 1, 1, 1, 10, 1, 1, 1, 10, 1 ],
	[ 1, 1, 10, 1, 1, 1, 1, 1, 1, 1, 1, 1, 1, 1, 1, 1 ],
	[ 1, 1, 10, 1, 10, 1, 1, 1, 10, 1, 1, 1, 1, 1, 1, 10 ],
	[ 1, 10, 1, 1, 1, 1, 1, 1, 1, 1, 10, 1, 1, 10, 1, 10 ],
	[ 1, 1, 1, 1, 1, 1, 10, 1, 10, 10, 1, 10, 1, 1, 1, 10 ],
	[ 10, 1, 1, 1, 1, 1, 10, 1, 1, 1, 1, 1, 1, 1, 1, 1 ],
	[ 1, 1, 1, 1, 1, 1, 1, 10, 1, 1, 10, 1, 10, 1, 1, 10 ],
	[ 1, 1, 10, 1, 1, 1, 1, 1, 1, 1, 1, 1, 1, 10, 1, 10 ]
],
"objects": [
	{
		"x": 3648,
		"y": 4896,
		"type": "TREE"
	}
],
"lastModified": 1730249043537
}