{
"x": 1,
"y": 12,
"biomeType": "PLAINS",
"tileData": [
	[ 10, 1, 1, 1, 1, 10, 1, 1, 1, 1, 1, 1, 1, 1, 1, 1 ],
	[ 1, 1, 1, 1, 1, 1, 1, 1, 1, 1, 1, 1, 10, 1, 1, 1 ],
	[ 1, 1, 1, 1, 1, 1, 1, 1, 1, 1, 1, 1, 1, 1, 10, 1 ],
	[ 1, 1, 1, 1, 1, 1, 10, 1, 1, 1, 1, 1, 10, 1, 10, 1 ],
	[ 1, 1, 1, 1, 1, 1, 1, 1, 1, 1, 1, 1, 1, 1, 1, 1 ],
	[ 1, 1, 10, 1, 1, 1, 1, 1, 1, 1, 1, 10, 1, 10, 1, 10 ],
	[ 1, 1, 10, 1, 10, 1, 1, 1, 10, 10, 1, 1, 10, 1, 1, 1 ],
	[ 1, 1, 1, 10, 1, 1, 1, 10, 1, 1, 1, 1, 1, 1, 10, 1 ],
	[ 1, 1, 10, 10, 1, 1, 10, 1, 10, 10, 1, 1, 1, 1, 1, 1 ],
	[ 1, 1, 1, 1, 1, 10, 1, 1, 1, 1, 1, 1, 1, 1, 1, 1 ],
	[ 1, 1, 1, 1, 1, 1, 10, 1, 1, 1, 1, 1, 1, 1, 1, 1 ],
	[ 1, 1, 1, 1, 1, 1, 1, 10, 1, 1, 1, 1, 1, 1, 1, 1 ],
	[ 10, 1, 1, 1, 1, 1, 10, 10, 1, 1, 1, 10, 1, 1, 1, 10 ],
	[ 1, 1, 1, 1, 1, 1, 1, 1, 10, 1, 1, 1, 1, 10, 10, 1 ],
	[ 10, 1, 1, 10, 10, 1, 10, 1, 1, 10, 1, 10, 10, 1, 1, 1 ],
	[ 1, 1, 1, 10, 10, 1, 1, 1, 1, 1, 1, 1, 1, 10, 1, 1 ]
],
"objects": [
	{
		"x": 576,
		"y": 6304,
		"type": "TREE"
	}
],
"lastModified": 1730248834125
}