{
"x": 6,
"y": 8,
"biomeType": "PLAINS",
"tileData": [
	[ 1, 1, 1, 1, 1, 1, 1, 1, 1, 1, 1, 1, 10, 1, 1, 1 ],
	[ 1, 1, 1, 10, 10, 1, 1, 10, 1, 1, 10, 10, 1, 1, 1, 10 ],
	[ 10, 1, 1, 10, 1, 10, 1, 1, 10, 1, 1, 10, 10, 10, 1, 1 ],
	[ 10, 10, 10, 1, 1, 1, 1, 1, 1, 1, 10, 1, 1, 1, 1, 1 ],
	[ 1, 1, 1, 1, 1, 1, 1, 10, 1, 1, 1, 1, 1, 1, 1, 1 ],
	[ 1, 10, 1, 1, 1, 10, 1, 10, 10, 1, 1, 1, 1, 1, 1, 10 ],
	[ 1, 10, 1, 1, 1, 1, 1, 1, 10, 1, 1, 1, 1, 10, 1, 1 ],
	[ 10, 1, 10, 1, 1, 1, 1, 1, 1, 1, 1, 1, 1, 10, 10, 1 ],
	[ 1, 1, 1, 1, 1, 10, 10, 1, 1, 1, 1, 1, 1, 1, 1, 1 ],
	[ 1, 1, 1, 1, 1, 1, 1, 10, 1, 1, 10, 1, 1, 1, 10, 1 ],
	[ 1, 1, 1, 1, 10, 1, 10, 1, 1, 1, 1, 1, 1, 1, 10, 1 ],
	[ 10, 1, 1, 1, 1, 10, 10, 1, 1, 1, 1, 1, 1, 10, 1, 1 ],
	[ 1, 1, 1, 1, 1, 10, 1, 1, 10, 1, 1, 1, 1, 1, 10, 1 ],
	[ 1, 1, 1, 1, 1, 1, 1, 10, 1, 1, 1, 1, 1, 1, 1, 10 ],
	[ 1, 10, 1, 1, 10, 1, 10, 1, 10, 10, 1, 1, 1, 1, 1, 1 ],
	[ 1, 10, 10, 1, 1, 10, 1, 1, 1, 10, 1, 1, 1, 1, 1, 10 ]
],
"objects": [
	{
		"x": 3456,
		"y": 4224,
		"type": "TREE"
	}
],
"lastModified": 1730248837777
}