{
"x": -2,
"y": 8,
"biomeType": "PLAINS",
"tileData": [
	[ 1, 1, 1, 1, 10, 1, 1, 1, 1, 1, 10, 10, 1, 1, 1, 10 ],
	[ 1, 1, 1, 10, 1, 1, 1, 1, 10, 1, 1, 10, 1, 1, 1, 1 ],
	[ 1, 1, 10, 1, 1, 1, 1, 1, 1, 1, 1, 10, 1, 10, 1, 1 ],
	[ 10, 10, 1, 1, 1, 1, 1, 1, 1, 1, 1, 1, 1, 1, 10, 1 ],
	[ 10, 1, 10, 1, 1, 10, 1, 1, 1, 1, 10, 1, 1, 1, 1, 1 ],
	[ 10, 10, 1, 1, 1, 1, 1, 1, 1, 10, 10, 1, 1, 1, 1, 1 ],
	[ 10, 1, 1, 10, 1, 1, 1, 10, 10, 1, 1, 1, 1, 1, 1, 1 ],
	[ 10, 1, 1, 1, 1, 10, 1, 1, 1, 1, 1, 10, 1, 10, 1, 1 ],
	[ 1, 10, 1, 1, 1, 1, 1, 10, 1, 1, 1, 1, 1, 1, 1, 1 ],
	[ 1, 1, 1, 1, 1, 1, 1, 1, 1, 10, 1, 1, 1, 1, 1, 1 ],
	[ 10, 10, 10, 10, 1, 1, 1, 1, 1, 1, 1, 1, 1, 1, 1, 1 ],
	[ 1, 1, 1, 1, 1, 1, 1, 1, 1, 10, 1, 10, 1, 1, 10, 1 ],
	[ 1, 1, 1, 1, 1, 1, 1, 10, 1, 1, 1, 1, 1, 1, 1, 1 ],
	[ 1, 1, 1, 1, 1, 1, 1, 1, 1, 1, 1, 1, 1, 10, 10, 10 ],
	[ 10, 1, 1, 1, 1, 1, 1, 1, 10, 10, 1, 1, 1, 10, 1, 1 ],
	[ 1, 1, 10, 1, 1, 1, 10, 1, 1, 1, 1, 1, 10, 1, 1, 1 ]
],
"objects": [
	{
		"x": -608,
		"y": 4160,
		"type": "POKEBALL"
	},
	{
		"x": -576,
		"y": 4288,
		"type": "POKEBALL"
	},
	{
		"x": -640,
		"y": 4544,
		"type": "POKEBALL"
	},
	{
		"x": -864,
		"y": 4448,
		"type": "POKEBALL"
	},
	{
		"x": -896,
		"y": 4384,
		"type": "POKEBALL"
	},
	{
		"x": -640,
		"y": 4480,
		"type": "POKEBALL"
	}
],
"lastModified": 1730208107986
}