{
"x": -3,
"biomeType": "HAUNTED",
"tileData": [
	[ 9, 5, 7, 5, 5, 5, 5, 9, 5, 9, 5, 9, 5, 9, 5, 7 ],
	[ 5, 5, 5, 8, 7, 5, 9, 5, 5, 5, 5, 9, 7, 9, 5, 5 ],
	[ 5, 7, 9, 5, 5, 5, 8, 9, 9, 9, 5, 5, 8, 8, 9, 5 ],
	[ 5, 5, 7, 5, 9, 5, 9, 8, 5, 5, 5, 7, 8, 7, 5, 5 ],
	[ 7, 7, 5, 5, 5, 5, 7, 5, 5, 5, 5, 9, 9, 5, 5, 5 ],
	[ 7, 5, 7, 5, 5, 9, 5, 5, 5, 5, 5, 5, 5, 8, 7, 5 ],
	[ 7, 5, 5, 5, 7, 9, 7, 5, 5, 8, 7, 5, 7, 9, 5, 5 ],
	[ 5, 5, 7, 9, 7, 5, 5, 5, 5, 5, 9, 9, 9, 5, 9, 5 ],
	[ 5, 5, 5, 7, 5, 9, 5, 5, 5, 5, 5, 9, 9, 9, 5, 7 ],
	[ 5, 5, 7, 5, 7, 5, 5, 9, 5, 7, 9, 5, 5, 5, 8, 5 ],
	[ 5, 5, 5, 9, 5, 5, 7, 9, 5, 5, 5, 5, 5, 5, 5, 9 ],
	[ 8, 9, 9, 5, 5, 5, 5, 7, 5, 5, 5, 7, 5, 9, 7, 5 ],
	[ 9, 8, 5, 7, 5, 5, 9, 5, 7, 5, 9, 5, 5, 5, 5, 5 ],
	[ 5, 9, 5, 5, 7, 7, 5, 7, 9, 7, 5, 5, 9, 5, 9, 7 ],
	[ 7, 5, 5, 5, 5, 9, 5, 9, 5, 5, 9, 5, 5, 7, 5, 5 ],
	[ 9, 5, 5, 7, 5, 5, 5, 5, 5, 7, 5, 5, 5, 9, 8, 5 ]
],
"objects": [
	{
		"x": -1184,
		"y": 256,
		"type": "HAUNTED_TREE"
	}
],
"lastModified": 1730175588116
}