{
"x": 3,
"y": 7,
"biomeType": "PLAINS",
"tileData": [
	[ 1, 1, 1, 1, 1, 1, 1, 1, 10, 10, 1, 1, 1, 1, 10, 1 ],
	[ 10, 10, 1, 1, 1, 1, 1, 1, 1, 1, 10, 1, 1, 1, 1, 10 ],
	[ 1, 1, 10, 10, 1, 1, 1, 1, 1, 10, 10, 1, 10, 1, 1, 1 ],
	[ 1, 1, 1, 10, 1, 1, 1, 1, 1, 10, 10, 1, 10, 1, 1, 1 ],
	[ 1, 10, 1, 1, 1, 1, 1, 1, 1, 1, 1, 1, 1, 1, 10, 1 ],
	[ 1, 1, 1, 10, 1, 10, 1, 1, 10, 1, 1, 1, 10, 1, 1, 10 ],
	[ 10, 1, 10, 1, 1, 1, 1, 10, 1, 10, 1, 10, 1, 1, 1, 1 ],
	[ 1, 10, 10, 10, 1, 1, 10, 1, 1, 10, 1, 1, 1, 1, 1, 1 ],
	[ 1, 10, 1, 1, 1, 1, 1, 1, 10, 1, 1, 1, 1, 1, 1, 1 ],
	[ 10, 1, 1, 1, 10, 1, 1, 1, 1, 1, 1, 1, 1, 1, 1, 1 ],
	[ 1, 10, 1, 1, 1, 1, 1, 1, 10, 1, 1, 10, 1, 1, 1, 1 ],
	[ 1, 1, 1, 10, 10, 10, 1, 1, 10, 10, 1, 1, 10, 10, 10, 10 ],
	[ 1, 1, 1, 1, 1, 1, 1, 1, 1, 1, 1, 10, 1, 1, 1, 10 ],
	[ 1, 10, 10, 1, 1, 1, 1, 1, 1, 10, 1, 10, 10, 1, 1, 1 ],
	[ 1, 1, 1, 1, 1, 10, 1, 1, 1, 1, 10, 1, 10, 10, 1, 1 ],
	[ 1, 1, 1, 10, 1, 1, 1, 1, 1, 10, 1, 10, 10, 10, 1, 1 ]
],
"objects": [
	{
		"x": 1600,
		"y": 3808,
		"type": "TREE"
	},
	{
		"x": 1888,
		"y": 3904,
		"type": "TREE"
	}
],
"lastModified": 1730175592859
}