{
"x": 2,
"y": 12,
"biomeType": "PLAINS",
"tileData": [
	[ 1, 1, 10, 1, 1, 1, 1, 1, 10, 1, 10, 1, 1, 1, 1, 1 ],
	[ 1, 1, 1, 10, 1, 1, 10, 1, 1, 1, 1, 1, 1, 1, 1, 1 ],
	[ 1, 1, 1, 1, 1, 10, 1, 1, 1, 1, 1, 1, 1, 1, 1, 1 ],
	[ 1, 1, 1, 10, 1, 10, 1, 1, 1, 1, 1, 10, 1, 1, 10, 1 ],
	[ 1, 10, 10, 10, 1, 10, 1, 1, 1, 1, 1, 1, 1, 10, 10, 10 ],
	[ 1, 1, 10, 1, 10, 1, 1, 1, 1, 1, 1, 1, 1, 1, 1, 1 ],
	[ 10, 1, 1, 10, 1, 10, 1, 1, 1, 1, 1, 1, 1, 1, 10, 1 ],
	[ 1, 1, 1, 10, 1, 1, 1, 1, 10, 1, 1, 1, 1, 1, 1, 1 ],
	[ 10, 1, 1, 1, 1, 1, 1, 1, 1, 1, 1, 1, 1, 1, 1, 1 ],
	[ 1, 1, 1, 10, 1, 1, 1, 1, 1, 1, 1, 1, 1, 1, 1, 10 ],
	[ 1, 1, 1, 1, 1, 1, 1, 1, 1, 1, 1, 1, 1, 1, 1, 1 ],
	[ 1, 1, 1, 10, 1, 1, 1, 1, 1, 1, 1, 10, 1, 10, 10, 10 ],
	[ 1, 1, 1, 1, 1, 10, 1, 1, 1, 1, 1, 1, 1, 1, 1, 1 ],
	[ 1, 1, 1, 1, 10, 10, 1, 10, 1, 1, 1, 1, 1, 10, 1, 1 ],
	[ 1, 1, 1, 1, 1, 10, 10, 1, 1, 10, 1, 1, 1, 1, 1, 10 ],
	[ 1, 10, 1, 1, 1, 1, 1, 1, 1, 1, 10, 1, 1, 1, 1, 10 ]
],
"lastModified": 1730248834129
}