{
"x": 3,
"y": 11,
"biomeType": "PLAINS",
"tileData": [
	[ 1, 10, 10, 1, 1, 1, 10, 1, 1, 1, 1, 10, 1, 1, 10, 1 ],
	[ 1, 1, 1, 1, 10, 10, 1, 10, 10, 1, 1, 1, 1, 1, 10, 1 ],
	[ 1, 10, 10, 10, 1, 1, 10, 1, 1, 1, 1, 1, 10, 1, 10, 1 ],
	[ 1, 1, 10, 1, 1, 1, 10, 1, 1, 1, 1, 1, 10, 10, 1, 10 ],
	[ 1, 10, 10, 1, 1, 1, 1, 1, 1, 1, 1, 1, 1, 1, 1, 1 ],
	[ 1, 1, 1, 1, 10, 10, 10, 1, 1, 1, 1, 1, 1, 10, 1, 1 ],
	[ 1, 1, 1, 1, 1, 1, 1, 1, 1, 1, 1, 1, 1, 10, 1, 10 ],
	[ 1, 1, 10, 1, 1, 1, 1, 1, 1, 10, 10, 1, 1, 1, 1, 1 ],
	[ 10, 1, 1, 1, 1, 10, 1, 1, 1, 1, 1, 1, 1, 1, 1, 1 ],
	[ 1, 10, 1, 1, 1, 1, 1, 1, 1, 1, 10, 1, 1, 1, 1, 1 ],
	[ 10, 10, 1, 1, 1, 1, 10, 1, 10, 1, 1, 1, 1, 1, 1, 1 ],
	[ 1, 1, 1, 1, 1, 1, 1, 1, 1, 1, 1, 10, 1, 1, 1, 1 ],
	[ 1, 1, 1, 1, 1, 1, 1, 1, 1, 1, 1, 1, 1, 1, 1, 10 ],
	[ 1, 1, 1, 1, 1, 1, 1, 1, 1, 1, 1, 1, 10, 1, 1, 1 ],
	[ 10, 1, 1, 1, 1, 10, 1, 1, 1, 1, 10, 1, 10, 1, 1, 10 ],
	[ 10, 1, 1, 10, 1, 1, 1, 1, 1, 1, 1, 10, 1, 1, 10, 1 ]
],
"objects": [
	{
		"x": 1664,
		"y": 5728,
		"type": "TREE"
	}
],
"lastModified": 1730175631723
}