{
"x": 6,
"y": 12,
"biomeType": "PLAINS",
"tileData": [
	[ 10, 10, 1, 10, 1, 10, 1, 1, 1, 1, 1, 1, 1, 10, 1, 1 ],
	[ 1, 1, 10, 1, 1, 1, 1, 1, 1, 1, 1, 1, 1, 1, 1, 1 ],
	[ 10, 1, 10, 1, 10, 1, 1, 1, 1, 10, 10, 1, 1, 10, 1, 1 ],
	[ 1, 1, 10, 10, 1, 1, 1, 10, 1, 1, 1, 1, 1, 1, 1, 1 ],
	[ 1, 1, 1, 1, 1, 1, 1, 1, 1, 1, 10, 1, 1, 1, 1, 10 ],
	[ 1, 1, 1, 10, 1, 1, 10, 1, 1, 1, 1, 1, 10, 10, 10, 1 ],
	[ 1, 1, 1, 1, 1, 1, 1, 1, 1, 1, 1, 1, 1, 1, 1, 1 ],
	[ 1, 1, 1, 1, 10, 1, 1, 10, 10, 1, 1, 1, 1, 1, 10, 1 ],
	[ 1, 1, 10, 1, 1, 1, 1, 1, 10, 1, 1, 1, 10, 1, 1, 1 ],
	[ 1, 1, 1, 1, 1, 1, 1, 1, 10, 10, 1, 1, 10, 10, 1, 1 ],
	[ 1, 1, 1, 1, 1, 1, 10, 1, 1, 1, 10, 10, 1, 1, 10, 1 ],
	[ 10, 10, 10, 1, 1, 10, 10, 1, 10, 1, 1, 1, 1, 1, 1, 1 ],
	[ 10, 1, 10, 1, 1, 10, 10, 1, 1, 1, 10, 10, 1, 1, 10, 10 ],
	[ 10, 1, 10, 1, 1, 1, 1, 1, 1, 1, 10, 1, 1, 1, 1, 1 ],
	[ 1, 1, 10, 1, 1, 10, 10, 1, 1, 10, 1, 1, 1, 1, 1, 1 ],
	[ 10, 10, 1, 10, 10, 1, 1, 1, 1, 1, 1, 1, 1, 1, 1, 1 ]
],
"lastModified": 1730248837783
}