{
"x": 1,
"y": -2,
"biomeType": "HAUNTED",
"tileData": [
	[ 5, 5, 5, 5, 7, 5, 5, 9, 7, 5, 5, 5, 5, 5, 5, 5 ],
	[ 5, 5, 5, 8, 5, 5, 5, 5, 5, 7, 5, 5, 9, 5, 5, 5 ],
	[ 5, 5, 5, 5, 7, 5, 7, 5, 5, 7, 5, 5, 9, 9, 5, 5 ],
	[ 5, 9, 5, 7, 5, 9, 5, 5, 7, 5, 9, 5, 5, 5, 5, 9 ],
	[ 5, 5, 9, 5, 5, 9, 7, 5, 5, 5, 7, 5, 8, 9, 7, 9 ],
	[ 5, 5, 5, 9, 7, 7, 5, 5, 9, 5, 7, 5, 9, 5, 5, 5 ],
	[ 9, 5, 7, 5, 5, 5, 5, 9, 5, 5, 8, 5, 5, 5, 9, 5 ],
	[ 7, 5, 5, 5, 5, 5, 5, 5, 9, 5, 5, 5, 7, 5, 7, 9 ],
	[ 5, 7, 5, 9, 9, 7, 7, 7, 5, 8, 9, 8, 5, 5, 5, 9 ],
	[ 9, 7, 5, 9, 7, 8, 5, 5, 5, 7, 5, 5, 9, 9, 5, 5 ],
	[ 5, 7, 5, 7, 9, 5, 9, 5, 5, 7, 5, 5, 5, 9, 5, 7 ],
	[ 5, 5, 9, 5, 5, 7, 5, 5, 9, 5, 5, 7, 5, 5, 9, 5 ],
	[ 5, 7, 5, 5, 8, 5, 5, 5, 5, 5, 7, 5, 9, 5, 7, 5 ],
	[ 7, 5, 5, 7, 5, 8, 5, 5, 5, 5, 5, 7, 9, 5, 9, 5 ],
	[ 5, 5, 5, 5, 8, 5, 9, 7, 5, 5, 5, 5, 5, 5, 9, 5 ],
	[ 5, 5, 5, 9, 5, 5, 5, 5, 9, 5, 5, 9, 5, 5, 5, 9 ]
],
"lastModified": 1730175580605
}