{
"x": 2,
"y": 3,
"biomeType": "HAUNTED",
"tileData": [
	[ 5, 7, 8, 9, 5, 5, 9, 5, 5, 5, 5, 5, 5, 9, 7, 7 ],
	[ 9, 5, 9, 7, 5, 9, 5, 5, 5, 5, 5, 9, 5, 5, 5, 5 ],
	[ 7, 5, 9, 5, 5, 5, 8, 5, 5, 5, 5, 5, 5, 9, 5, 5 ],
	[ 5, 5, 9, 9, 7, 8, 9, 5, 7, 5, 9, 5, 5, 5, 5, 5 ],
	[ 9, 5, 9, 5, 7, 9, 5, 5, 7, 5, 7, 5, 5, 7, 5, 5 ],
	[ 5, 5, 9, 9, 5, 9, 9, 9, 5, 9, 5, 5, 7, 5, 5, 5 ],
	[ 5, 9, 5, 9, 5, 5, 5, 9, 5, 5, 5, 5, 5, 5, 5, 5 ],
	[ 8, 5, 7, 5, 5, 5, 5, 9, 5, 5, 5, 5, 9, 9, 5, 7 ],
	[ 5, 5, 5, 5, 5, 5, 5, 5, 9, 5, 8, 9, 5, 7, 5, 5 ],
	[ 8, 9, 5, 9, 5, 5, 5, 9, 9, 8, 5, 5, 9, 9, 5, 5 ],
	[ 7, 5, 5, 9, 9, 5, 7, 5, 5, 5, 5, 5, 5, 5, 5, 9 ],
	[ 8, 5, 5, 5, 5, 5, 5, 5, 9, 7, 5, 5, 5, 8, 5, 5 ],
	[ 5, 5, 5, 9, 5, 5, 9, 5, 5, 5, 5, 9, 7, 5, 5, 5 ],
	[ 5, 5, 5, 9, 8, 5, 5, 7, 5, 5, 5, 5, 5, 5, 5, 5 ],
	[ 5, 9, 7, 5, 5, 8, 5, 8, 5, 8, 5, 7, 7, 5, 7, 5 ],
	[ 5, 9, 5, 5, 5, 9, 5, 7, 5, 7, 9, 5, 5, 5, 5, 5 ]
],
"objects": [
	{
		"x": 1280,
		"y": 1888,
		"type": "HAUNTED_TREE"
	}
],
"lastModified": 1730175620448
}