{
"x": 4,
"y": 11,
"biomeType": "PLAINS",
"tileData": [
	[ 1, 1, 10, 1, 1, 1, 1, 1, 1, 10, 1, 1, 1, 1, 1, 1 ],
	[ 1, 1, 1, 1, 1, 1, 10, 1, 1, 1, 1, 1, 1, 1, 1, 1 ],
	[ 1, 1, 1, 10, 10, 1, 1, 1, 10, 10, 1, 1, 1, 10, 1, 1 ],
	[ 1, 10, 1, 1, 1, 1, 1, 10, 1, 1, 1, 10, 1, 1, 1, 1 ],
	[ 1, 1, 1, 1, 10, 1, 1, 1, 1, 1, 10, 1, 1, 1, 1, 10 ],
	[ 1, 1, 1, 1, 1, 1, 1, 10, 10, 1, 10, 1, 10, 1, 1, 1 ],
	[ 1, 1, 10, 1, 1, 1, 1, 1, 10, 1, 1, 10, 1, 1, 1, 1 ],
	[ 10, 1, 1, 1, 1, 1, 10, 1, 1, 1, 1, 1, 1, 1, 1, 10 ],
	[ 1, 1, 10, 1, 1, 1, 1, 1, 1, 1, 10, 10, 1, 1, 1, 1 ],
	[ 1, 1, 1, 10, 1, 10, 1, 10, 10, 1, 1, 1, 1, 1, 1, 1 ],
	[ 1, 1, 1, 1, 1, 1, 1, 10, 1, 10, 1, 1, 1, 1, 1, 10 ],
	[ 1, 1, 1, 10, 1, 1, 1, 1, 10, 1, 1, 1, 1, 1, 1, 1 ],
	[ 10, 1, 10, 1, 1, 1, 1, 1, 10, 1, 10, 1, 1, 10, 1, 1 ],
	[ 1, 10, 10, 1, 1, 1, 10, 1, 1, 1, 1, 1, 1, 1, 10, 1 ],
	[ 1, 1, 10, 1, 1, 1, 1, 1, 1, 1, 10, 1, 1, 1, 1, 1 ],
	[ 1, 1, 1, 1, 1, 1, 10, 10, 1, 10, 1, 1, 1, 1, 1, 1 ]
],
"objects": [
	{
		"x": 2048,
		"y": 6080,
		"type": "POKEBALL"
	},
	{
		"x": 2368,
		"y": 5728,
		"type": "POKEBALL"
	},
	{
		"x": 2528,
		"y": 5664,
		"type": "POKEBALL"
	},
	{
		"x": 2336,
		"y": 5824,
		"type": "POKEBALL"
	},
	{
		"x": 2080,
		"y": 5952,
		"type": "POKEBALL"
	},
	{
		"x": 2080,
		"y": 5664,
		"type": "POKEBALL"
	},
	{
		"x": 2496,
		"y": 6016,
		"type": "POKEBALL"
	}
],
"lastModified": 1730208108003
}