{
"x": 5,
"y": 12,
"biomeType": "PLAINS",
"tileData": [
	[ 10, 1, 1, 1, 1, 1, 10, 1, 1, 10, 1, 10, 1, 1, 1, 1 ],
	[ 1, 1, 1, 1, 1, 10, 10, 1, 1, 10, 1, 1, 1, 1, 1, 10 ],
	[ 1, 1, 1, 1, 1, 1, 1, 1, 1, 1, 10, 1, 1, 10, 10, 10 ],
	[ 1, 1, 1, 1, 10, 1, 10, 1, 1, 1, 10, 1, 1, 1, 1, 1 ],
	[ 1, 1, 1, 10, 1, 10, 10, 1, 1, 10, 1, 1, 10, 1, 1, 1 ],
	[ 1, 1, 1, 1, 1, 1, 1, 1, 1, 1, 1, 1, 1, 1, 1, 1 ],
	[ 1, 1, 10, 1, 1, 1, 1, 1, 10, 1, 1, 1, 1, 1, 10, 10 ],
	[ 10, 1, 1, 10, 1, 1, 1, 10, 1, 10, 10, 1, 1, 10, 10, 1 ],
	[ 1, 1, 1, 1, 1, 1, 1, 1, 10, 1, 1, 10, 1, 1, 1, 1 ],
	[ 10, 1, 1, 1, 1, 1, 10, 1, 1, 10, 1, 1, 1, 1, 1, 1 ],
	[ 1, 1, 1, 10, 1, 10, 1, 1, 1, 1, 1, 1, 1, 10, 1, 1 ],
	[ 1, 1, 1, 1, 1, 1, 1, 1, 1, 1, 10, 1, 1, 1, 1, 1 ],
	[ 1, 1, 1, 1, 1, 10, 10, 1, 1, 1, 10, 1, 1, 1, 10, 1 ],
	[ 1, 1, 1, 1, 10, 1, 1, 1, 10, 1, 1, 1, 1, 1, 1, 10 ],
	[ 1, 10, 10, 10, 1, 1, 1, 10, 1, 1, 1, 1, 1, 1, 1, 10 ],
	[ 1, 1, 10, 1, 1, 1, 10, 1, 1, 1, 1, 1, 1, 1, 1, 1 ]
],
"objects": [
	{
		"x": 2752,
		"y": 6432,
		"type": "TREE"
	}
],
"lastModified": 1730248834169
}