{
"y": 1,
"biomeType": "HAUNTED",
"tileData": [
	[ 5, 5, 5, 7, 5, 9, 5, 5, 5, 7, 5, 7, 5, 9, 5, 9 ],
	[ 5, 7, 5, 5, 5, 5, 5, 5, 5, 5, 7, 5, 5, 5, 7, 9 ],
	[ 5, 7, 7, 5, 7, 9, 5, 5, 5, 9, 8, 5, 9, 5, 5, 5 ],
	[ 5, 5, 7, 5, 7, 5, 5, 9, 7, 5, 5, 5, 5, 5, 5, 9 ],
	[ 5, 5, 5, 5, 5, 5, 5, 5, 5, 5, 5, 5, 5, 5, 5, 5 ],
	[ 7, 7, 5, 9, 9, 5, 9, 7, 5, 5, 5, 5, 5, 5, 5, 5 ],
	[ 5, 7, 5, 5, 5, 5, 5, 5, 5, 5, 5, 5, 5, 5, 5, 5 ],
	[ 5, 9, 7, 9, 5, 5, 5, 7, 9, 9, 5, 9, 7, 5, 9, 9 ],
	[ 7, 7, 7, 5, 5, 5, 5, 5, 5, 5, 5, 5, 9, 9, 5, 5 ],
	[ 9, 5, 5, 5, 5, 9, 5, 9, 7, 5, 5, 5, 7, 5, 9, 7 ],
	[ 5, 7, 5, 9, 5, 5, 5, 5, 5, 9, 7, 7, 9, 5, 9, 5 ],
	[ 5, 5, 5, 7, 5, 5, 7, 5, 5, 5, 9, 5, 7, 5, 9, 5 ],
	[ 5, 5, 5, 7, 7, 9, 9, 7, 9, 7, 5, 9, 7, 9, 7, 5 ],
	[ 5, 5, 5, 5, 5, 5, 9, 5, 7, 5, 9, 7, 9, 7, 5, 5 ],
	[ 9, 5, 5, 5, 9, 8, 5, 5, 7, 5, 9, 7, 5, 5, 5, 9 ],
	[ 5, 5, 5, 9, 7, 7, 9, 5, 5, 5, 5, 5, 5, 7, 9, 7 ]
],
"objects": [
	{
		"x": 64,
		"y": 800,
		"type": "HAUNTED_TREE"
	}
],
"lastModified": 1730125488103
}