{
"x": 2,
"y": 1,
"biomeType": "HAUNTED",
"tileData": [
	[ 5, 9, 5, 5, 5, 9, 5, 5, 9, 7, 8, 7, 5, 9, 9, 5 ],
	[ 5, 5, 9, 5, 9, 7, 5, 9, 5, 5, 5, 5, 5, 7, 5, 9 ],
	[ 9, 5, 9, 5, 5, 5, 7, 5, 5, 5, 8, 5, 5, 5, 5, 5 ],
	[ 5, 5, 5, 7, 5, 5, 5, 5, 8, 9, 5, 9, 9, 5, 9, 5 ],
	[ 5, 9, 5, 5, 5, 7, 5, 8, 5, 9, 7, 9, 5, 9, 5, 5 ],
	[ 5, 5, 5, 5, 7, 5, 5, 5, 7, 9, 5, 5, 5, 5, 5, 7 ],
	[ 9, 9, 5, 5, 5, 5, 5, 5, 5, 5, 5, 5, 5, 7, 7, 9 ],
	[ 5, 5, 5, 5, 9, 7, 5, 7, 7, 7, 5, 9, 5, 5, 5, 5 ],
	[ 5, 5, 5, 5, 7, 5, 9, 5, 9, 9, 8, 5, 5, 7, 7, 9 ],
	[ 5, 7, 7, 5, 7, 5, 5, 5, 5, 5, 7, 5, 5, 5, 8, 5 ],
	[ 5, 5, 9, 7, 5, 5, 5, 5, 5, 5, 5, 7, 5, 5, 5, 5 ],
	[ 9, 7, 5, 5, 7, 9, 5, 9, 7, 5, 5, 5, 5, 5, 5, 5 ],
	[ 5, 5, 5, 5, 5, 5, 8, 5, 9, 5, 5, 7, 5, 7, 5, 5 ],
	[ 5, 5, 5, 5, 5, 5, 5, 5, 9, 9, 7, 5, 8, 5, 5, 5 ],
	[ 5, 7, 8, 5, 9, 5, 5, 5, 5, 9, 5, 9, 5, 5, 5, 9 ],
	[ 5, 5, 5, 5, 8, 9, 5, 9, 9, 9, 5, 5, 5, 5, 5, 7 ]
],
"objects": [
	{
		"x": 1152,
		"y": 832,
		"type": "HAUNTED_TREE"
	}
],
"lastModified": 1730125488113
}