{
"y": -1,
"biomeType": "HAUNTED",
"tileData": [
	[ 9, 5, 5, 9, 5, 5, 9, 9, 5, 5, 5, 7, 5, 5, 9, 9 ],
	[ 9, 5, 9, 5, 5, 5, 5, 9, 5, 9, 7, 5, 5, 9, 5, 9 ],
	[ 5, 7, 9, 7, 9, 7, 8, 5, 9, 5, 9, 5, 5, 7, 5, 9 ],
	[ 5, 5, 9, 5, 5, 5, 5, 5, 9, 8, 7, 9, 7, 5, 7, 5 ],
	[ 5, 5, 5, 7, 5, 9, 5, 5, 5, 5, 5, 5, 5, 5, 5, 9 ],
	[ 9, 5, 5, 5, 5, 5, 5, 5, 5, 5, 5, 5, 5, 5, 5, 5 ],
	[ 9, 5, 9, 5, 7, 5, 5, 5, 5, 5, 5, 5, 7, 5, 5, 5 ],
	[ 5, 5, 5, 7, 7, 9, 5, 5, 7, 9, 9, 5, 5, 5, 5, 9 ],
	[ 5, 5, 5, 5, 5, 5, 5, 5, 5, 9, 5, 7, 7, 5, 9, 9 ],
	[ 5, 7, 5, 7, 5, 5, 7, 5, 5, 5, 5, 5, 5, 5, 9, 8 ],
	[ 5, 9, 5, 5, 5, 5, 5, 7, 5, 5, 5, 5, 5, 5, 5, 5 ],
	[ 5, 7, 5, 5, 5, 9, 5, 5, 5, 5, 7, 7, 5, 7, 5, 5 ],
	[ 9, 7, 5, 5, 5, 9, 5, 5, 5, 9, 5, 5, 9, 9, 5, 9 ],
	[ 5, 5, 5, 8, 5, 5, 5, 5, 5, 9, 5, 5, 5, 7, 9, 5 ],
	[ 5, 5, 7, 8, 5, 9, 9, 9, 5, 7, 5, 7, 5, 5, 9, 5 ],
	[ 7, 7, 9, 5, 9, 5, 8, 8, 9, 5, 5, 9, 5, 5, 5, 7 ]
],
"lastModified": 1730125488098
}