{
"x": 14,
"y": 1,
"biomeType": "PLAINS",
"tileData": [
	[ 1, 1, 1, 10, 10, 1, 1, 1, 1, 1, 1, 1, 1, 1, 1, 1 ],
	[ 10, 1, 10, 1, 1, 1, 1, 1, 1, 10, 1, 1, 1, 1, 10, 1 ],
	[ 1, 1, 1, 1, 1, 1, 10, 1, 1, 10, 1, 1, 10, 10, 10, 1 ],
	[ 1, 1, 1, 1, 1, 1, 1, 1, 1, 1, 1, 10, 1, 10, 10, 1 ],
	[ 10, 1, 1, 1, 1, 10, 10, 1, 10, 1, 1, 1, 1, 1, 10, 1 ],
	[ 1, 1, 1, 1, 1, 1, 1, 1, 1, 1, 1, 1, 10, 1, 10, 1 ],
	[ 10, 1, 10, 1, 1, 10, 1, 1, 1, 1, 1, 1, 10, 1, 1, 1 ],
	[ 1, 1, 10, 1, 1, 1, 10, 1, 1, 10, 1, 1, 1, 1, 10, 1 ],
	[ 1, 10, 10, 1, 10, 1, 10, 1, 1, 1, 1, 1, 1, 1, 1, 1 ],
	[ 10, 1, 10, 1, 1, 10, 1, 1, 1, 1, 1, 1, 1, 1, 1, 1 ],
	[ 1, 10, 1, 1, 1, 1, 10, 10, 1, 10, 10, 1, 1, 1, 1, 1 ],
	[ 1, 10, 1, 1, 1, 1, 1, 1, 10, 1, 1, 1, 1, 1, 1, 1 ],
	[ 10, 1, 10, 1, 1, 1, 10, 1, 1, 1, 1, 1, 10, 1, 1, 1 ],
	[ 1, 10, 10, 1, 1, 10, 1, 1, 10, 1, 1, 1, 1, 1, 1, 1 ],
	[ 1, 1, 1, 1, 1, 1, 1, 1, 1, 10, 1, 10, 1, 1, 1, 10 ],
	[ 10, 1, 1, 1, 1, 1, 1, 1, 1, 1, 1, 1, 1, 1, 1, 1 ]
],
"objects": [
	{
		"x": 7488,
		"y": 736,
		"type": "TREE"
	}
],
"lastModified": 1730099724173
}