{
"x": 6,
"y": 5,
"biomeType": "PLAINS",
"tileData": [
	[ 1, 1, 1, 1, 10, 10, 1, 10, 1, 1, 1, 1, 1, 1, 1, 1 ],
	[ 1, 10, 1, 1, 10, 1, 1, 10, 1, 1, 1, 1, 1, 1, 1, 1 ],
	[ 10, 10, 10, 1, 1, 1, 1, 1, 10, 1, 10, 1, 1, 10, 1, 1 ],
	[ 1, 1, 1, 1, 1, 1, 1, 10, 1, 1, 10, 10, 1, 1, 1, 1 ],
	[ 1, 10, 1, 1, 1, 10, 1, 1, 1, 1, 1, 1, 1, 10, 1, 1 ],
	[ 1, 1, 1, 1, 1, 1, 10, 1, 1, 1, 10, 1, 10, 1, 1, 1 ],
	[ 1, 10, 1, 1, 1, 1, 1, 1, 1, 1, 1, 1, 1, 1, 10, 10 ],
	[ 1, 1, 1, 1, 1, 1, 10, 1, 1, 1, 10, 1, 1, 10, 10, 1 ],
	[ 1, 1, 1, 1, 1, 1, 1, 1, 1, 1, 1, 10, 1, 10, 1, 1 ],
	[ 1, 1, 1, 10, 1, 1, 1, 1, 1, 10, 1, 10, 1, 1, 1, 10 ],
	[ 1, 10, 10, 1, 1, 1, 1, 1, 1, 10, 10, 1, 1, 10, 1, 10 ],
	[ 1, 10, 1, 1, 1, 1, 1, 1, 1, 1, 1, 1, 1, 1, 1, 1 ],
	[ 1, 1, 1, 10, 1, 1, 1, 1, 10, 1, 1, 10, 1, 10, 1, 1 ],
	[ 1, 1, 1, 1, 1, 10, 10, 1, 1, 1, 1, 10, 1, 1, 1, 1 ],
	[ 10, 1, 1, 1, 1, 1, 1, 1, 1, 1, 10, 1, 1, 10, 1, 1 ],
	[ 1, 10, 10, 1, 1, 1, 1, 1, 1, 1, 1, 1, 1, 1, 1, 10 ]
],
"objects": [
	{
		"x": 3328,
		"y": 2688,
		"type": "POKEBALL"
	},
	{
		"x": 3360,
		"y": 2784,
		"type": "POKEBALL"
	},
	{
		"x": 3072,
		"y": 2752,
		"type": "POKEBALL"
	},
	{
		"x": 3552,
		"y": 3008,
		"type": "POKEBALL"
	},
	{
		"x": 3200,
		"y": 2848,
		"type": "POKEBALL"
	},
	{
		"x": 3136,
		"y": 2720,
		"type": "POKEBALL"
	},
	{
		"x": 3168,
		"y": 2592,
		"type": "POKEBALL"
	},
	{
		"x": 3232,
		"y": 2720,
		"type": "POKEBALL"
	},
	{
		"x": 3552,
		"y": 2656,
		"type": "POKEBALL"
	}
],
"lastModified": 1730099721313
}