{
"x": 9,
"y": -2,
"biomeType": "HAUNTED",
"tileData": [
	[ 9, 7, 9, 9, 5, 5, 5, 9, 5, 5, 7, 5, 9, 5, 5, 5 ],
	[ 7, 5, 5, 5, 5, 9, 5, 5, 5, 9, 5, 9, 9, 5, 5, 5 ],
	[ 9, 5, 5, 5, 5, 5, 5, 5, 9, 5, 9, 5, 5, 5, 7, 9 ],
	[ 5, 5, 7, 5, 5, 5, 9, 5, 5, 5, 5, 8, 5, 7, 5, 5 ],
	[ 5, 5, 5, 5, 9, 7, 7, 5, 9, 5, 8, 5, 8, 5, 9, 5 ],
	[ 5, 5, 5, 5, 5, 5, 5, 9, 7, 5, 5, 9, 5, 5, 5, 5 ],
	[ 5, 5, 5, 9, 7, 8, 5, 5, 5, 5, 5, 5, 5, 9, 9, 7 ],
	[ 9, 5, 7, 7, 5, 7, 5, 7, 5, 8, 5, 9, 8, 9, 5, 5 ],
	[ 5, 5, 7, 5, 9, 5, 9, 5, 5, 5, 5, 5, 5, 9, 5, 5 ],
	[ 5, 7, 7, 5, 5, 9, 9, 5, 5, 5, 5, 5, 5, 5, 5, 5 ],
	[ 5, 9, 5, 5, 7, 5, 7, 5, 7, 5, 9, 5, 5, 9, 5, 5 ],
	[ 5, 5, 5, 5, 5, 5, 7, 7, 5, 5, 5, 9, 7, 5, 5, 7 ],
	[ 5, 5, 5, 7, 9, 5, 5, 5, 5, 5, 5, 5, 9, 9, 8, 7 ],
	[ 9, 9, 5, 5, 5, 5, 9, 7, 5, 5, 5, 5, 9, 5, 5, 9 ],
	[ 5, 9, 7, 7, 5, 5, 9, 5, 5, 5, 7, 8, 5, 7, 5, 5 ],
	[ 7, 8, 5, 5, 5, 9, 5, 5, 7, 5, 5, 5, 8, 5, 5, 5 ]
],
"objects": [
	{
		"x": 4928,
		"y": -928,
		"type": "HAUNTED_TREE"
	}
],
"lastModified": 1730099721308
}