{
"x": 13,
"biomeType": "PLAINS",
"tileData": [
	[ 1, 1, 1, 1, 1, 1, 10, 10, 1, 1, 10, 1, 1, 1, 1, 1 ],
	[ 1, 1, 10, 10, 1, 1, 10, 1, 1, 1, 1, 1, 10, 1, 10, 1 ],
	[ 1, 10, 1, 1, 10, 1, 1, 10, 1, 1, 1, 1, 1, 1, 1, 1 ],
	[ 1, 1, 10, 1, 10, 1, 1, 1, 10, 1, 10, 1, 10, 10, 1, 1 ],
	[ 1, 1, 1, 1, 10, 1, 1, 10, 1, 1, 10, 1, 1, 1, 1, 1 ],
	[ 1, 1, 1, 10, 1, 1, 10, 1, 10, 1, 1, 1, 1, 1, 10, 1 ],
	[ 1, 1, 1, 1, 1, 10, 1, 1, 1, 1, 1, 1, 1, 1, 1, 1 ],
	[ 1, 1, 10, 1, 10, 1, 10, 1, 1, 1, 1, 1, 1, 1, 1, 1 ],
	[ 1, 1, 10, 10, 1, 1, 10, 1, 10, 1, 1, 1, 1, 1, 1, 1 ],
	[ 1, 1, 1, 1, 10, 1, 1, 1, 10, 1, 10, 1, 10, 10, 1, 10 ],
	[ 10, 1, 1, 1, 1, 1, 10, 1, 10, 10, 1, 1, 1, 1, 1, 1 ],
	[ 1, 1, 1, 1, 1, 1, 1, 1, 1, 10, 1, 1, 1, 1, 1, 1 ],
	[ 10, 10, 1, 1, 10, 1, 10, 1, 1, 1, 1, 1, 1, 1, 10, 1 ],
	[ 1, 1, 1, 1, 1, 1, 1, 1, 1, 1, 1, 1, 10, 1, 1, 1 ],
	[ 10, 1, 1, 1, 1, 1, 1, 1, 1, 1, 10, 1, 10, 1, 1, 10 ],
	[ 10, 1, 1, 10, 1, 1, 1, 1, 1, 1, 10, 10, 1, 1, 1, 1 ]
],
"objects": [
	{
		"x": 6816,
		"y": 160,
		"type": "TREE"
	}
],
"lastModified": 1730099716297
}