{
"x": 9,
"y": 5,
"biomeType": "PLAINS",
"tileData": [
	[ 1, 1, 1, 1, 1, 10, 1, 1, 1, 1, 10, 1, 1, 1, 1, 1 ],
	[ 1, 1, 1, 1, 10, 1, 1, 1, 1, 1, 1, 1, 1, 1, 1, 1 ],
	[ 10, 1, 1, 1, 1, 1, 1, 1, 1, 1, 1, 1, 1, 1, 10, 1 ],
	[ 1, 1, 1, 1, 1, 1, 1, 1, 1, 1, 10, 1, 1, 1, 1, 10 ],
	[ 10, 1, 1, 10, 10, 1, 1, 1, 1, 1, 1, 10, 1, 1, 10, 1 ],
	[ 1, 1, 1, 10, 10, 1, 1, 1, 1, 1, 10, 1, 1, 1, 1, 1 ],
	[ 1, 1, 1, 1, 1, 1, 1, 10, 1, 10, 1, 1, 1, 1, 1, 1 ],
	[ 10, 1, 1, 1, 1, 1, 10, 1, 1, 10, 1, 1, 10, 1, 10, 1 ],
	[ 1, 1, 1, 1, 1, 1, 10, 1, 1, 1, 1, 1, 10, 10, 1, 1 ],
	[ 1, 1, 1, 1, 1, 10, 1, 1, 10, 1, 1, 1, 1, 1, 1, 1 ],
	[ 10, 10, 1, 10, 1, 1, 1, 1, 1, 1, 10, 1, 10, 1, 1, 1 ],
	[ 1, 1, 1, 1, 1, 1, 1, 1, 1, 1, 1, 1, 1, 1, 1, 1 ],
	[ 1, 1, 1, 10, 1, 1, 10, 1, 10, 1, 1, 1, 1, 1, 1, 1 ],
	[ 1, 1, 10, 1, 1, 1, 1, 1, 10, 1, 1, 10, 1, 1, 1, 10 ],
	[ 1, 1, 1, 1, 1, 1, 1, 1, 1, 10, 1, 1, 1, 1, 1, 1 ],
	[ 1, 1, 1, 1, 10, 1, 10, 1, 1, 10, 1, 10, 1, 1, 1, 10 ]
],
"objects": [
	{
		"x": 5056,
		"y": 3040,
		"type": "POKEBALL"
	},
	{
		"x": 4736,
		"y": 2784,
		"type": "POKEBALL"
	},
	{
		"x": 5056,
		"y": 2816,
		"type": "POKEBALL"
	},
	{
		"x": 4896,
		"y": 2752,
		"type": "POKEBALL"
	},
	{
		"x": 4928,
		"y": 2816,
		"type": "POKEBALL"
	}
],
"lastModified": 1730099721314
}