{
"x": 5,
"y": 5,
"biomeType": "PLAINS",
"tileData": [
	[ 1, 1, 1, 1, 1, 1, 1, 10, 1, 1, 1, 1, 1, 1, 1, 1 ],
	[ 1, 1, 1, 1, 1, 1, 1, 1, 1, 1, 1, 1, 1, 1, 10, 1 ],
	[ 1, 10, 1, 1, 1, 10, 1, 1, 1, 1, 1, 10, 1, 1, 1, 1 ],
	[ 1, 1, 1, 1, 1, 1, 1, 1, 1, 1, 1, 1, 1, 1, 1, 10 ],
	[ 10, 1, 1, 1, 1, 1, 1, 1, 1, 1, 1, 1, 1, 1, 10, 10 ],
	[ 1, 1, 1, 1, 1, 1, 1, 1, 1, 1, 1, 1, 1, 10, 1, 1 ],
	[ 1, 1, 10, 1, 1, 10, 10, 1, 10, 10, 1, 10, 1, 1, 1, 1 ],
	[ 1, 1, 10, 1, 1, 1, 1, 1, 1, 1, 1, 10, 1, 10, 10, 1 ],
	[ 1, 1, 10, 1, 1, 1, 1, 10, 1, 1, 1, 1, 1, 1, 1, 10 ],
	[ 1, 1, 1, 10, 10, 1, 1, 10, 1, 1, 1, 1, 1, 10, 1, 1 ],
	[ 1, 1, 1, 1, 1, 10, 1, 1, 1, 1, 1, 1, 10, 1, 1, 1 ],
	[ 10, 1, 10, 10, 10, 10, 10, 1, 1, 1, 1, 1, 1, 1, 1, 1 ],
	[ 1, 1, 1, 10, 1, 1, 10, 1, 1, 1, 1, 10, 1, 1, 1, 1 ],
	[ 10, 1, 1, 1, 1, 1, 1, 1, 1, 1, 1, 10, 1, 10, 1, 1 ],
	[ 10, 1, 1, 1, 1, 1, 1, 1, 1, 10, 10, 1, 1, 1, 10, 1 ],
	[ 1, 10, 1, 1, 1, 1, 1, 1, 10, 1, 1, 1, 10, 1, 1, 1 ]
],
"objects": [
	{
		"x": 2688,
		"y": 2816,
		"type": "TREE"
	},
	{
		"x": 2976,
		"y": 2816,
		"type": "POKEBALL"
	},
	{
		"x": 2816,
		"y": 2944,
		"type": "POKEBALL"
	},
	{
		"x": 2656,
		"y": 2624,
		"type": "POKEBALL"
	},
	{
		"x": 2912,
		"y": 2816,
		"type": "POKEBALL"
	},
	{
		"x": 2944,
		"y": 2624,
		"type": "POKEBALL"
	},
	{
		"x": 3008,
		"y": 2976,
		"type": "POKEBALL"
	},
	{
		"x": 2752,
		"y": 2688,
		"type": "POKEBALL"
	},
	{
		"x": 2848,
		"y": 2816,
		"type": "POKEBALL"
	}
],
"lastModified": 1730099721314
}