{
"x": 9,
"y": 1,
"biomeType": "PLAINS",
"tileData": [
	[ 1, 1, 10, 10, 1, 10, 1, 1, 10, 1, 1, 1, 10, 1, 1, 10 ],
	[ 1, 1, 10, 1, 10, 1, 1, 1, 1, 1, 1, 1, 1, 1, 1, 1 ],
	[ 1, 1, 1, 1, 1, 1, 1, 1, 1, 1, 10, 1, 1, 10, 10, 10 ],
	[ 1, 1, 1, 1, 1, 10, 1, 1, 1, 1, 10, 1, 10, 1, 1, 1 ],
	[ 10, 10, 1, 10, 1, 1, 1, 1, 10, 1, 1, 10, 10, 1, 10, 1 ],
	[ 1, 1, 1, 1, 1, 1, 1, 10, 1, 1, 1, 10, 10, 10, 1, 1 ],
	[ 10, 1, 1, 1, 1, 1, 1, 1, 1, 1, 1, 1, 10, 1, 1, 10 ],
	[ 1, 1, 1, 1, 1, 10, 1, 1, 1, 1, 1, 10, 1, 1, 10, 10 ],
	[ 1, 1, 1, 10, 1, 10, 10, 1, 1, 1, 10, 1, 1, 1, 1, 1 ],
	[ 1, 1, 1, 1, 1, 10, 1, 1, 1, 1, 1, 1, 1, 1, 1, 1 ],
	[ 1, 1, 1, 1, 10, 1, 1, 1, 10, 1, 1, 1, 1, 1, 10, 1 ],
	[ 1, 1, 1, 1, 1, 1, 1, 1, 1, 1, 1, 1, 1, 1, 10, 10 ],
	[ 1, 1, 1, 1, 10, 1, 1, 1, 10, 1, 10, 10, 1, 1, 1, 1 ],
	[ 10, 10, 1, 1, 1, 10, 1, 1, 1, 1, 1, 1, 1, 1, 1, 1 ],
	[ 10, 10, 1, 10, 1, 1, 1, 10, 1, 10, 1, 1, 1, 1, 1, 1 ],
	[ 1, 1, 1, 1, 1, 1, 1, 10, 1, 1, 1, 1, 1, 1, 1, 1 ]
],
"objects": [
	{
		"x": 4672,
		"y": 768,
		"type": "TREE"
	}
],
"lastModified": 1730099682211
}