{
"x": 4,
"y": 1,
"biomeType": "HAUNTED",
"tileData": [
	[ 5, 8, 5, 5, 5, 9, 5, 5, 7, 5, 9, 5, 5, 5, 7, 5 ],
	[ 9, 5, 5, 5, 7, 5, 5, 5, 9, 5, 5, 8, 9, 9, 5, 5 ],
	[ 5, 5, 5, 7, 7, 5, 5, 9, 5, 5, 5, 5, 9, 5, 7, 5 ],
	[ 5, 5, 7, 8, 9, 5, 5, 9, 9, 5, 5, 5, 5, 9, 9, 5 ],
	[ 9, 7, 8, 9, 9, 5, 9, 7, 5, 5, 9, 5, 5, 9, 5, 5 ],
	[ 9, 5, 5, 5, 5, 8, 7, 9, 7, 5, 5, 9, 5, 5, 5, 5 ],
	[ 9, 8, 7, 5, 9, 5, 5, 9, 5, 5, 5, 9, 5, 9, 5, 9 ],
	[ 9, 5, 9, 5, 9, 5, 5, 5, 5, 5, 7, 5, 7, 5, 5, 5 ],
	[ 7, 9, 5, 9, 5, 5, 5, 5, 5, 9, 5, 5, 9, 5, 7, 7 ],
	[ 9, 7, 8, 9, 9, 5, 5, 9, 5, 5, 9, 9, 9, 5, 5, 5 ],
	[ 9, 9, 5, 5, 5, 5, 5, 5, 9, 5, 5, 5, 5, 5, 5, 5 ],
	[ 5, 7, 5, 7, 5, 9, 5, 5, 9, 7, 5, 9, 5, 5, 9, 5 ],
	[ 5, 5, 7, 5, 9, 5, 5, 7, 9, 5, 9, 5, 7, 5, 5, 5 ],
	[ 5, 5, 5, 5, 8, 5, 5, 5, 5, 9, 5, 5, 5, 5, 5, 5 ],
	[ 9, 5, 7, 5, 7, 5, 5, 5, 5, 9, 7, 5, 5, 9, 5, 9 ],
	[ 9, 5, 5, 7, 9, 5, 5, 5, 5, 5, 5, 5, 5, 5, 5, 9 ]
],
"objects": [
	{
		"x": 2336,
		"y": 640,
		"type": "HAUNTED_TREE"
	}
],
"lastModified": 1730099724175
}