{
"x": 7,
"y": 5,
"biomeType": "PLAINS",
"tileData": [
	[ 1, 1, 1, 1, 10, 1, 1, 1, 1, 10, 1, 1, 1, 1, 1, 10 ],
	[ 10, 10, 10, 1, 1, 1, 10, 10, 1, 1, 1, 10, 1, 10, 1, 1 ],
	[ 1, 1, 10, 1, 1, 10, 1, 1, 1, 1, 10, 1, 1, 1, 1, 1 ],
	[ 1, 1, 10, 1, 1, 1, 1, 1, 10, 1, 1, 1, 1, 1, 10, 10 ],
	[ 10, 1, 1, 1, 10, 1, 1, 1, 10, 1, 10, 1, 1, 1, 1, 1 ],
	[ 1, 1, 1, 1, 1, 1, 1, 1, 1, 1, 1, 1, 1, 1, 1, 1 ],
	[ 1, 1, 1, 1, 1, 1, 1, 1, 1, 1, 1, 1, 1, 1, 1, 1 ],
	[ 1, 1, 10, 1, 1, 10, 1, 10, 1, 1, 10, 1, 1, 1, 1, 1 ],
	[ 1, 1, 1, 10, 1, 1, 1, 1, 1, 1, 1, 10, 1, 1, 1, 1 ],
	[ 10, 1, 1, 1, 1, 1, 1, 10, 1, 1, 1, 10, 1, 1, 1, 1 ],
	[ 1, 1, 1, 1, 1, 1, 1, 1, 1, 1, 1, 10, 1, 10, 1, 10 ],
	[ 1, 1, 1, 1, 10, 1, 1, 1, 10, 1, 1, 10, 1, 1, 10, 1 ],
	[ 1, 1, 1, 1, 10, 1, 1, 10, 1, 1, 10, 1, 10, 10, 1, 1 ],
	[ 1, 1, 1, 1, 1, 1, 1, 1, 1, 1, 1, 1, 1, 10, 1, 1 ],
	[ 10, 10, 10, 1, 1, 1, 1, 10, 1, 1, 10, 1, 1, 1, 1, 1 ],
	[ 1, 1, 1, 1, 10, 1, 1, 10, 1, 1, 1, 1, 1, 1, 1, 10 ]
],
"objects": [
	{
		"x": 3904,
		"y": 2880,
		"type": "TREE"
	},
	{
		"x": 4000,
		"y": 2784,
		"type": "POKEBALL"
	},
	{
		"x": 3968,
		"y": 2656,
		"type": "POKEBALL"
	},
	{
		"x": 3584,
		"y": 2752,
		"type": "POKEBALL"
	},
	{
		"x": 3648,
		"y": 2688,
		"type": "POKEBALL"
	},
	{
		"x": 3712,
		"y": 3008,
		"type": "POKEBALL"
	},
	{
		"x": 3584,
		"y": 2816,
		"type": "POKEBALL"
	},
	{
		"x": 4032,
		"y": 2688,
		"type": "POKEBALL"
	}
],
"lastModified": 1730099721312
}