{
"x": 4,
"y": 5,
"biomeType": "PLAINS",
"tileData": [
	[ 10, 1, 1, 1, 1, 1, 1, 1, 1, 1, 1, 1, 1, 1, 1, 1 ],
	[ 1, 1, 1, 1, 1, 10, 1, 1, 1, 1, 1, 1, 1, 1, 1, 1 ],
	[ 1, 1, 1, 1, 1, 10, 1, 1, 1, 10, 1, 1, 1, 1, 10, 1 ],
	[ 1, 10, 10, 1, 1, 10, 10, 1, 1, 10, 1, 1, 1, 10, 1, 1 ],
	[ 10, 1, 10, 1, 1, 1, 10, 1, 1, 1, 1, 1, 1, 1, 1, 1 ],
	[ 1, 10, 1, 1, 1, 1, 1, 1, 1, 1, 1, 1, 10, 10, 1, 1 ],
	[ 10, 1, 10, 1, 1, 1, 1, 1, 10, 1, 10, 1, 1, 10, 1, 10 ],
	[ 10, 1, 1, 1, 1, 10, 1, 1, 1, 1, 1, 1, 1, 1, 10, 10 ],
	[ 1, 10, 1, 1, 10, 1, 1, 1, 1, 1, 1, 1, 1, 1, 1, 10 ],
	[ 1, 1, 1, 1, 1, 1, 1, 1, 10, 1, 1, 1, 10, 1, 1, 1 ],
	[ 1, 1, 1, 1, 1, 1, 1, 1, 1, 1, 1, 1, 1, 1, 10, 1 ],
	[ 1, 10, 1, 10, 1, 10, 1, 1, 1, 10, 10, 10, 1, 1, 1, 1 ],
	[ 1, 10, 1, 1, 1, 1, 1, 1, 1, 1, 1, 1, 1, 1, 1, 10 ],
	[ 1, 1, 1, 1, 1, 10, 1, 1, 1, 1, 1, 1, 1, 1, 1, 1 ],
	[ 1, 1, 1, 10, 1, 1, 1, 1, 1, 10, 1, 1, 1, 1, 1, 1 ],
	[ 1, 1, 1, 1, 10, 1, 1, 10, 1, 1, 1, 1, 10, 1, 1, 1 ]
],
"objects": [
	{
		"x": 2240,
		"y": 2912,
		"type": "POKEBALL"
	},
	{
		"x": 2272,
		"y": 2688,
		"type": "POKEBALL"
	},
	{
		"x": 2048,
		"y": 2656,
		"type": "POKEBALL"
	},
	{
		"x": 2048,
		"y": 2752,
		"type": "POKEBALL"
	},
	{
		"x": 2464,
		"y": 2816,
		"type": "POKEBALL"
	}
],
"lastModified": 1730099721316
}