{
"x": 13,
"y": 5,
"biomeType": "PLAINS",
"tileData": [
	[ 10, 1, 1, 10, 1, 1, 1, 1, 10, 1, 1, 1, 1, 1, 10, 1 ],
	[ 10, 1, 10, 1, 1, 1, 1, 10, 10, 10, 1, 1, 1, 1, 1, 10 ],
	[ 1, 1, 10, 1, 10, 10, 1, 10, 1, 1, 1, 1, 1, 1, 10, 1 ],
	[ 1, 1, 1, 1, 1, 1, 1, 10, 10, 10, 1, 1, 1, 1, 1, 10 ],
	[ 1, 1, 1, 1, 10, 10, 10, 1, 1, 1, 1, 1, 1, 1, 1, 1 ],
	[ 1, 1, 10, 1, 1, 10, 1, 1, 1, 1, 1, 1, 1, 1, 1, 1 ],
	[ 1, 1, 1, 1, 1, 1, 1, 1, 10, 1, 10, 1, 1, 1, 1, 1 ],
	[ 1, 1, 1, 1, 1, 1, 1, 1, 1, 1, 1, 1, 1, 1, 10, 1 ],
	[ 1, 1, 1, 1, 1, 10, 1, 1, 10, 1, 1, 1, 1, 1, 1, 10 ],
	[ 1, 1, 1, 1, 1, 1, 10, 10, 1, 10, 1, 1, 1, 1, 10, 1 ],
	[ 1, 1, 1, 1, 10, 1, 1, 1, 1, 1, 1, 1, 1, 1, 1, 1 ],
	[ 1, 1, 1, 1, 1, 1, 1, 1, 1, 1, 1, 1, 1, 1, 1, 1 ],
	[ 1, 1, 1, 1, 1, 1, 1, 1, 10, 10, 1, 1, 10, 1, 10, 1 ],
	[ 1, 1, 1, 10, 1, 1, 1, 1, 1, 1, 1, 10, 10, 1, 1, 1 ],
	[ 1, 1, 1, 1, 1, 1, 1, 1, 1, 1, 1, 1, 1, 1, 1, 1 ],
	[ 1, 10, 1, 10, 1, 1, 1, 1, 1, 1, 1, 1, 1, 1, 1, 10 ]
],
"objects": [
	{
		"x": 6912,
		"y": 2752,
		"type": "TREE"
	}
],
"lastModified": 1730143366382
}