{
"x": 6,
"y": 6,
"biomeType": "PLAINS",
"tileData": [
	[ 1, 10, 1, 1, 1, 1, 1, 1, 1, 1, 1, 1, 1, 1, 1, 1 ],
	[ 1, 1, 1, 1, 1, 1, 10, 1, 1, 1, 1, 1, 1, 1, 1, 1 ],
	[ 1, 1, 1, 1, 1, 1, 1, 1, 1, 10, 1, 1, 10, 1, 1, 1 ],
	[ 1, 1, 1, 10, 1, 1, 10, 1, 10, 1, 1, 10, 1, 1, 10, 1 ],
	[ 1, 1, 1, 1, 1, 10, 1, 1, 10, 1, 1, 1, 1, 1, 1, 1 ],
	[ 1, 10, 1, 1, 1, 1, 1, 1, 1, 10, 1, 1, 10, 1, 1, 1 ],
	[ 1, 1, 1, 1, 1, 1, 1, 1, 1, 1, 10, 1, 1, 1, 1, 1 ],
	[ 1, 1, 1, 1, 1, 1, 1, 1, 1, 1, 10, 1, 1, 1, 1, 1 ],
	[ 1, 1, 1, 1, 1, 1, 10, 1, 1, 1, 1, 10, 1, 1, 1, 1 ],
	[ 10, 1, 1, 1, 1, 1, 1, 1, 1, 10, 1, 10, 10, 1, 1, 1 ],
	[ 1, 1, 1, 1, 1, 10, 10, 1, 10, 1, 10, 1, 10, 1, 1, 1 ],
	[ 1, 1, 1, 1, 1, 1, 10, 1, 1, 1, 1, 1, 1, 1, 10, 1 ],
	[ 1, 1, 10, 1, 1, 1, 1, 1, 1, 1, 1, 1, 1, 1, 1, 1 ],
	[ 1, 1, 1, 10, 1, 10, 1, 1, 10, 1, 1, 1, 1, 1, 10, 1 ],
	[ 1, 1, 10, 1, 10, 1, 1, 10, 1, 10, 1, 1, 10, 1, 1, 1 ],
	[ 10, 10, 1, 1, 10, 1, 10, 1, 1, 1, 1, 1, 1, 1, 1, 1 ]
],
"objects": [
	{
		"x": 3136,
		"y": 3136,
		"type": "TREE"
	}
],
"lastModified": 1730100888871
}