{
"x": 12,
"y": 3,
"biomeType": "PLAINS",
"tileData": [
	[ 1, 1, 1, 1, 1, 1, 10, 10, 1, 10, 1, 1, 10, 1, 1, 1 ],
	[ 1, 1, 1, 1, 1, 1, 1, 1, 1, 1, 10, 1, 10, 1, 1, 1 ],
	[ 1, 1, 1, 1, 1, 1, 1, 1, 1, 1, 10, 1, 1, 10, 1, 1 ],
	[ 1, 10, 1, 10, 1, 1, 1, 10, 10, 1, 10, 1, 1, 10, 1, 1 ],
	[ 1, 1, 1, 1, 1, 1, 1, 10, 10, 1, 1, 1, 1, 1, 1, 1 ],
	[ 10, 1, 1, 1, 10, 1, 1, 10, 1, 1, 10, 1, 1, 10, 1, 1 ],
	[ 1, 10, 10, 1, 1, 10, 1, 1, 1, 1, 1, 1, 10, 1, 1, 1 ],
	[ 1, 1, 10, 10, 1, 1, 10, 1, 10, 1, 10, 1, 1, 10, 10, 1 ],
	[ 1, 1, 1, 1, 1, 1, 10, 1, 1, 1, 1, 1, 1, 10, 1, 10 ],
	[ 10, 10, 1, 1, 1, 1, 1, 1, 10, 1, 1, 1, 1, 1, 1, 1 ],
	[ 10, 1, 1, 1, 1, 1, 1, 1, 1, 1, 1, 10, 1, 1, 1, 1 ],
	[ 10, 10, 10, 1, 1, 1, 10, 1, 10, 1, 10, 1, 10, 10, 1, 10 ],
	[ 1, 1, 1, 1, 1, 10, 1, 1, 1, 1, 1, 1, 10, 1, 1, 1 ],
	[ 1, 1, 1, 1, 1, 1, 1, 10, 1, 1, 1, 10, 1, 1, 10, 10 ],
	[ 1, 1, 1, 1, 1, 1, 10, 1, 1, 1, 1, 10, 1, 1, 1, 1 ],
	[ 1, 1, 1, 1, 10, 1, 10, 1, 1, 1, 1, 1, 1, 1, 1, 1 ]
],
"objects": [
	{
		"x": 6208,
		"y": 1664,
		"type": "TREE"
	},
	{
		"x": 6240,
		"y": 1728,
		"type": "TREE"
	}
],
"lastModified": 1730099712245
}