{
"x": 6,
"y": 1,
"biomeType": "HAUNTED",
"tileData": [
	[ 5, 7, 9, 7, 5, 5, 8, 9, 5, 5, 5, 5, 9, 5, 8, 5 ],
	[ 7, 5, 5, 7, 7, 5, 5, 9, 5, 5, 5, 7, 5, 5, 9, 5 ],
	[ 5, 7, 9, 5, 5, 5, 7, 5, 9, 5, 5, 5, 9, 5, 9, 5 ],
	[ 7, 5, 8, 9, 5, 5, 5, 5, 9, 5, 9, 9, 5, 5, 9, 7 ],
	[ 5, 5, 5, 5, 9, 7, 5, 9, 5, 5, 8, 5, 5, 5, 9, 5 ],
	[ 5, 5, 9, 5, 5, 5, 7, 5, 5, 5, 5, 5, 5, 5, 9, 5 ],
	[ 7, 5, 5, 5, 5, 5, 5, 9, 5, 5, 5, 5, 5, 5, 5, 5 ],
	[ 7, 5, 5, 5, 5, 5, 7, 5, 5, 5, 7, 9, 5, 5, 8, 5 ],
	[ 5, 5, 8, 7, 7, 5, 5, 7, 7, 9, 9, 9, 5, 5, 5, 5 ],
	[ 5, 5, 5, 7, 5, 9, 5, 9, 5, 9, 5, 9, 5, 5, 5, 5 ],
	[ 5, 5, 7, 5, 9, 5, 9, 5, 5, 9, 5, 5, 7, 5, 5, 7 ],
	[ 5, 5, 9, 7, 8, 7, 9, 9, 5, 9, 7, 9, 5, 7, 9, 9 ],
	[ 7, 5, 5, 5, 9, 5, 5, 5, 5, 9, 7, 9, 9, 5, 5, 5 ],
	[ 5, 7, 5, 5, 5, 5, 5, 5, 7, 5, 5, 5, 5, 5, 7, 9 ],
	[ 5, 9, 7, 5, 9, 9, 7, 7, 5, 5, 5, 5, 5, 5, 9, 7 ],
	[ 9, 7, 5, 5, 5, 5, 9, 9, 5, 5, 5, 5, 5, 5, 5, 5 ]
],
"objects": [
	{
		"x": 3232,
		"y": 832,
		"type": "HAUNTED_TREE"
	}
],
"lastModified": 1730099682197
}