{
"x": 10,
"y": 3,
"biomeType": "PLAINS",
"tileData": [
	[ 10, 1, 1, 10, 1, 1, 1, 1, 1, 1, 1, 1, 1, 1, 10, 1 ],
	[ 1, 1, 1, 1, 1, 1, 1, 1, 1, 1, 10, 10, 1, 10, 1, 1 ],
	[ 1, 1, 10, 1, 1, 1, 10, 10, 1, 10, 10, 1, 1, 1, 1, 1 ],
	[ 1, 10, 10, 1, 1, 10, 1, 1, 1, 1, 10, 1, 10, 1, 1, 1 ],
	[ 10, 1, 1, 1, 1, 1, 1, 10, 1, 1, 1, 1, 1, 10, 1, 1 ],
	[ 1, 1, 1, 1, 1, 1, 1, 10, 1, 1, 1, 1, 1, 1, 1, 1 ],
	[ 1, 1, 1, 1, 1, 10, 10, 1, 1, 1, 1, 1, 1, 1, 1, 10 ],
	[ 10, 1, 1, 1, 10, 1, 1, 1, 1, 10, 1, 1, 1, 1, 1, 1 ],
	[ 1, 1, 1, 1, 1, 10, 1, 1, 1, 1, 1, 10, 1, 1, 1, 1 ],
	[ 1, 1, 1, 1, 10, 1, 10, 1, 1, 1, 1, 1, 10, 1, 1, 10 ],
	[ 1, 1, 1, 1, 10, 1, 1, 1, 1, 1, 1, 1, 10, 1, 1, 1 ],
	[ 1, 10, 1, 1, 10, 1, 1, 1, 1, 1, 1, 1, 1, 1, 1, 10 ],
	[ 1, 1, 10, 1, 10, 1, 1, 10, 1, 1, 1, 1, 1, 1, 1, 1 ],
	[ 1, 1, 10, 1, 10, 1, 1, 1, 10, 1, 1, 1, 1, 10, 1, 1 ],
	[ 1, 1, 1, 1, 1, 1, 1, 10, 1, 10, 1, 1, 10, 10, 10, 1 ],
	[ 1, 1, 1, 10, 1, 1, 1, 1, 1, 1, 10, 1, 10, 10, 1, 10 ]
],
"lastModified": 1730099705504
}