{
"x": 9,
"y": 7,
"biomeType": "PLAINS",
"tileData": [
	[ 1, 1, 1, 1, 1, 1, 1, 1, 1, 1, 1, 1, 10, 10, 10, 10 ],
	[ 1, 1, 1, 1, 1, 1, 1, 1, 10, 1, 1, 10, 1, 1, 1, 10 ],
	[ 1, 1, 1, 1, 1, 10, 1, 1, 1, 1, 1, 1, 1, 1, 1, 1 ],
	[ 1, 10, 1, 1, 10, 1, 1, 10, 1, 1, 1, 1, 1, 1, 1, 1 ],
	[ 1, 10, 1, 1, 1, 1, 1, 1, 1, 1, 1, 1, 1, 10, 10, 1 ],
	[ 10, 1, 1, 1, 1, 1, 1, 1, 1, 1, 1, 1, 1, 1, 1, 1 ],
	[ 1, 1, 1, 1, 10, 1, 10, 1, 10, 1, 1, 1, 1, 1, 1, 1 ],
	[ 1, 1, 10, 1, 1, 10, 10, 1, 1, 1, 1, 10, 1, 1, 10, 1 ],
	[ 1, 1, 10, 1, 1, 1, 1, 1, 10, 10, 1, 1, 1, 1, 1, 1 ],
	[ 1, 1, 1, 1, 1, 1, 1, 1, 1, 1, 1, 10, 10, 1, 1, 1 ],
	[ 1, 1, 10, 1, 10, 1, 1, 1, 1, 1, 1, 1, 10, 10, 1, 1 ],
	[ 1, 10, 10, 1, 1, 1, 1, 10, 1, 1, 1, 1, 1, 10, 10, 1 ],
	[ 1, 10, 1, 1, 1, 1, 1, 1, 10, 10, 1, 1, 10, 1, 1, 1 ],
	[ 1, 1, 1, 1, 1, 1, 1, 1, 10, 1, 1, 1, 1, 1, 10, 1 ],
	[ 1, 1, 1, 1, 1, 10, 1, 1, 1, 1, 10, 1, 10, 10, 10, 1 ],
	[ 10, 1, 1, 1, 1, 1, 1, 1, 1, 1, 1, 1, 1, 1, 10, 1 ]
],
"objects": [
	{
		"x": 4928,
		"y": 3904,
		"type": "TREE"
	}
],
"lastModified": 1730120465267
}