{
"x": 8,
"y": 1,
"biomeType": "HAUNTED",
"tileData": [
	[ 5, 5, 5, 5, 8, 9, 5, 7, 5, 5, 5, 5, 9, 9, 5, 5 ],
	[ 9, 5, 9, 5, 5, 5, 5, 5, 9, 5, 5, 7, 5, 8, 5, 7 ],
	[ 5, 5, 9, 5, 5, 5, 9, 5, 5, 5, 7, 5, 5, 7, 9, 5 ],
	[ 8, 5, 7, 5, 9, 5, 5, 5, 5, 5, 7, 5, 5, 5, 9, 5 ],
	[ 7, 7, 5, 8, 5, 5, 5, 5, 5, 5, 5, 5, 9, 5, 9, 5 ],
	[ 7, 5, 9, 5, 5, 8, 5, 5, 9, 5, 5, 5, 7, 7, 5, 9 ],
	[ 7, 5, 5, 5, 5, 5, 5, 7, 5, 5, 5, 5, 5, 5, 9, 5 ],
	[ 9, 5, 5, 5, 5, 7, 5, 5, 5, 9, 7, 5, 5, 5, 7, 5 ],
	[ 7, 5, 7, 5, 5, 5, 7, 5, 9, 5, 5, 5, 9, 5, 5, 5 ],
	[ 5, 9, 5, 9, 5, 5, 9, 9, 5, 8, 9, 5, 5, 8, 9, 9 ],
	[ 5, 5, 5, 5, 5, 5, 5, 9, 5, 5, 7, 5, 5, 7, 5, 5 ],
	[ 9, 5, 7, 5, 9, 9, 7, 7, 9, 5, 5, 9, 8, 5, 5, 9 ],
	[ 5, 5, 9, 5, 9, 5, 5, 9, 5, 7, 5, 5, 5, 5, 9, 7 ],
	[ 9, 5, 7, 7, 9, 9, 5, 5, 5, 5, 7, 9, 5, 5, 7, 5 ],
	[ 9, 5, 5, 9, 5, 5, 8, 5, 5, 9, 5, 5, 9, 5, 9, 5 ],
	[ 7, 5, 7, 5, 5, 5, 5, 5, 5, 5, 9, 5, 7, 5, 7, 9 ]
],
"objects": [
	{
		"x": 4192,
		"y": 736,
		"type": "HAUNTED_TREE"
	},
	{
		"x": 4288,
		"y": 736,
		"type": "HAUNTED_TREE"
	}
],
"lastModified": 1730099682203
}