{
"x": 11,
"y": 6,
"biomeType": "PLAINS",
"tileData": [
	[ 1, 1, 1, 1, 1, 1, 1, 10, 1, 1, 1, 10, 10, 1, 1, 10 ],
	[ 1, 1, 1, 1, 1, 10, 10, 1, 1, 1, 1, 1, 1, 1, 10, 1 ],
	[ 1, 10, 1, 1, 1, 1, 1, 1, 1, 1, 1, 1, 1, 1, 1, 1 ],
	[ 1, 10, 1, 10, 10, 1, 1, 10, 10, 1, 1, 1, 1, 1, 1, 1 ],
	[ 1, 1, 1, 1, 1, 1, 1, 1, 1, 1, 1, 1, 1, 10, 1, 1 ],
	[ 1, 1, 1, 1, 1, 10, 10, 1, 1, 1, 1, 1, 1, 1, 1, 1 ],
	[ 10, 1, 10, 1, 1, 1, 1, 1, 1, 1, 1, 1, 10, 10, 10, 1 ],
	[ 10, 1, 1, 1, 10, 1, 10, 1, 1, 10, 1, 1, 1, 1, 1, 1 ],
	[ 10, 1, 1, 1, 1, 1, 1, 1, 1, 1, 1, 1, 1, 1, 10, 1 ],
	[ 1, 1, 1, 1, 1, 10, 1, 10, 1, 1, 1, 1, 1, 1, 1, 1 ],
	[ 10, 1, 10, 1, 1, 1, 1, 1, 1, 1, 10, 10, 1, 1, 1, 1 ],
	[ 1, 1, 1, 1, 1, 10, 1, 1, 1, 1, 1, 10, 1, 1, 1, 1 ],
	[ 1, 10, 1, 1, 1, 10, 10, 1, 1, 1, 1, 1, 1, 1, 1, 10 ],
	[ 1, 1, 1, 1, 1, 1, 1, 1, 1, 1, 1, 1, 1, 10, 1, 1 ],
	[ 1, 1, 10, 1, 1, 1, 10, 1, 10, 1, 1, 1, 1, 10, 1, 1 ],
	[ 10, 1, 10, 1, 1, 1, 1, 1, 1, 1, 10, 1, 1, 1, 10, 10 ]
],
"lastModified": 1730118389946
}