{
"x": 8,
"y": 8,
"biomeType": "PLAINS",
"tileData": [
	[ 10, 1, 1, 1, 1, 1, 1, 1, 10, 1, 10, 1, 1, 1, 1, 1 ],
	[ 1, 1, 10, 1, 10, 1, 1, 10, 1, 1, 1, 1, 10, 1, 1, 10 ],
	[ 1, 10, 1, 1, 1, 10, 1, 10, 1, 1, 1, 1, 1, 10, 1, 10 ],
	[ 1, 10, 1, 1, 1, 1, 1, 1, 1, 1, 1, 10, 1, 1, 1, 1 ],
	[ 1, 1, 1, 10, 10, 1, 1, 1, 10, 1, 1, 1, 1, 1, 1, 10 ],
	[ 1, 1, 1, 10, 1, 1, 1, 1, 1, 10, 1, 1, 10, 1, 1, 1 ],
	[ 1, 1, 10, 1, 1, 1, 10, 1, 1, 1, 1, 1, 1, 1, 1, 1 ],
	[ 1, 1, 10, 1, 10, 1, 1, 1, 1, 1, 10, 10, 1, 1, 1, 1 ],
	[ 1, 1, 1, 1, 1, 1, 10, 1, 1, 10, 1, 1, 1, 1, 1, 10 ],
	[ 1, 1, 1, 1, 1, 1, 10, 10, 1, 1, 1, 10, 10, 1, 1, 1 ],
	[ 1, 1, 1, 1, 10, 1, 1, 1, 1, 1, 10, 1, 1, 1, 1, 1 ],
	[ 1, 1, 10, 10, 1, 1, 10, 10, 10, 1, 1, 1, 10, 1, 10, 1 ],
	[ 10, 1, 1, 1, 1, 10, 1, 1, 1, 10, 1, 1, 10, 10, 1, 1 ],
	[ 1, 10, 10, 1, 1, 1, 1, 1, 1, 10, 1, 1, 1, 1, 1, 10 ],
	[ 1, 1, 10, 10, 1, 10, 1, 1, 1, 1, 1, 10, 1, 10, 1, 1 ],
	[ 1, 1, 1, 10, 1, 1, 1, 1, 10, 1, 1, 1, 10, 1, 1, 10 ]
],
"lastModified": 1730143359944
}