{
"x": 8,
"y": 7,
"biomeType": "PLAINS",
"tileData": [
	[ 1, 1, 1, 1, 1, 10, 1, 1, 1, 1, 10, 1, 1, 1, 1, 1 ],
	[ 10, 10, 1, 1, 1, 1, 1, 1, 1, 1, 1, 1, 10, 10, 1, 10 ],
	[ 10, 1, 1, 1, 1, 10, 1, 1, 1, 1, 10, 10, 1, 1, 1, 1 ],
	[ 1, 1, 1, 1, 1, 10, 1, 1, 10, 1, 1, 1, 1, 1, 1, 1 ],
	[ 1, 1, 1, 1, 1, 1, 1, 1, 1, 1, 10, 1, 1, 1, 10, 1 ],
	[ 1, 1, 10, 1, 1, 1, 1, 1, 1, 10, 1, 10, 1, 1, 1, 1 ],
	[ 1, 10, 1, 10, 1, 1, 10, 1, 1, 10, 1, 1, 1, 10, 1, 1 ],
	[ 10, 1, 1, 1, 10, 1, 1, 1, 1, 10, 1, 1, 10, 1, 10, 1 ],
	[ 1, 10, 1, 1, 1, 1, 10, 10, 10, 1, 1, 10, 1, 1, 10, 1 ],
	[ 1, 1, 1, 10, 10, 1, 1, 1, 10, 1, 1, 1, 1, 1, 1, 1 ],
	[ 1, 1, 1, 10, 1, 1, 10, 10, 1, 1, 1, 1, 10, 1, 1, 1 ],
	[ 10, 1, 1, 1, 10, 1, 1, 1, 10, 1, 1, 1, 1, 1, 1, 1 ],
	[ 1, 10, 1, 1, 10, 1, 10, 1, 1, 1, 1, 10, 1, 1, 1, 1 ],
	[ 1, 1, 10, 1, 1, 10, 1, 1, 1, 1, 1, 1, 1, 1, 1, 1 ],
	[ 1, 1, 1, 1, 1, 1, 10, 10, 1, 1, 10, 1, 1, 1, 1, 10 ],
	[ 1, 1, 1, 10, 1, 1, 1, 1, 1, 1, 1, 10, 1, 10, 1, 10 ]
],
"lastModified": 1730120465261
}