{
"x": 10,
"y": -1,
"biomeType": "HAUNTED",
"tileData": [
	[ 5, 5, 5, 8, 5, 5, 9, 8, 5, 7, 5, 5, 7, 9, 5, 9 ],
	[ 9, 9, 9, 5, 5, 9, 5, 5, 8, 5, 8, 5, 5, 5, 9, 7 ],
	[ 5, 5, 5, 8, 9, 5, 7, 5, 9, 9, 5, 5, 9, 5, 5, 7 ],
	[ 7, 9, 5, 7, 5, 9, 5, 5, 5, 5, 5, 9, 5, 5, 8, 5 ],
	[ 5, 7, 9, 5, 5, 5, 5, 5, 5, 5, 5, 9, 9, 9, 5, 8 ],
	[ 5, 5, 5, 7, 5, 8, 5, 9, 9, 7, 5, 7, 9, 5, 5, 5 ],
	[ 5, 9, 5, 7, 5, 5, 5, 5, 5, 5, 7, 9, 5, 5, 5, 5 ],
	[ 9, 9, 7, 9, 5, 5, 5, 5, 9, 5, 5, 9, 7, 7, 5, 5 ],
	[ 5, 9, 5, 9, 8, 5, 5, 5, 5, 5, 5, 5, 5, 5, 5, 9 ],
	[ 5, 9, 5, 5, 5, 9, 5, 9, 5, 9, 9, 5, 5, 5, 9, 7 ],
	[ 5, 7, 5, 5, 5, 5, 5, 9, 5, 5, 5, 9, 5, 5, 7, 5 ],
	[ 5, 9, 9, 7, 5, 5, 7, 5, 9, 5, 9, 5, 5, 5, 7, 5 ],
	[ 7, 5, 7, 9, 7, 5, 5, 5, 9, 5, 5, 8, 5, 5, 9, 5 ],
	[ 9, 5, 7, 5, 5, 5, 5, 8, 5, 9, 5, 5, 9, 5, 5, 5 ],
	[ 9, 7, 9, 5, 5, 5, 7, 5, 7, 5, 5, 5, 5, 5, 9, 5 ],
	[ 5, 7, 9, 5, 5, 9, 5, 8, 7, 5, 5, 9, 5, 5, 9, 5 ]
],
"objects": [
	{
		"x": 5440,
		"y": -192,
		"type": "HAUNTED_TREE"
	}
],
"lastModified": 1730099705500
}