{
"x": 8,
"y": 5,
"biomeType": "PLAINS",
"tileData": [
	[ 1, 1, 10, 10, 1, 1, 1, 1, 1, 1, 1, 1, 10, 1, 1, 1 ],
	[ 1, 1, 10, 1, 1, 1, 1, 10, 1, 1, 1, 1, 1, 1, 1, 10 ],
	[ 1, 1, 1, 10, 1, 1, 10, 1, 1, 1, 10, 1, 1, 1, 10, 1 ],
	[ 1, 1, 1, 1, 1, 1, 1, 1, 1, 1, 1, 10, 1, 1, 1, 1 ],
	[ 1, 1, 1, 10, 10, 1, 10, 1, 1, 10, 1, 1, 1, 1, 1, 10 ],
	[ 1, 1, 1, 1, 1, 10, 1, 1, 1, 1, 1, 1, 1, 1, 1, 10 ],
	[ 1, 10, 10, 1, 1, 1, 10, 1, 1, 1, 1, 1, 1, 1, 1, 1 ],
	[ 1, 1, 1, 1, 10, 1, 1, 1, 1, 1, 1, 10, 1, 1, 10, 10 ],
	[ 1, 1, 1, 1, 10, 1, 1, 1, 1, 1, 1, 1, 1, 1, 1, 10 ],
	[ 1, 10, 1, 1, 1, 10, 1, 1, 1, 1, 1, 10, 10, 1, 1, 10 ],
	[ 1, 10, 1, 1, 1, 10, 1, 1, 1, 1, 1, 10, 1, 10, 10, 10 ],
	[ 1, 1, 1, 1, 1, 10, 1, 1, 1, 1, 1, 10, 10, 1, 10, 1 ],
	[ 1, 1, 1, 1, 1, 1, 1, 10, 1, 1, 1, 1, 1, 10, 1, 10 ],
	[ 1, 1, 1, 1, 1, 1, 1, 1, 10, 1, 10, 1, 10, 1, 1, 1 ],
	[ 1, 10, 1, 10, 1, 1, 10, 1, 10, 1, 10, 1, 10, 1, 1, 1 ],
	[ 1, 10, 1, 1, 1, 10, 1, 1, 1, 1, 1, 1, 1, 1, 10, 1 ]
],
"objects": [
	{
		"x": 4320,
		"y": 2720,
		"type": "TREE"
	},
	{
		"x": 4224,
		"y": 2976,
		"type": "POKEBALL"
	},
	{
		"x": 4576,
		"y": 2976,
		"type": "POKEBALL"
	},
	{
		"x": 4096,
		"y": 2720,
		"type": "POKEBALL"
	},
	{
		"x": 4576,
		"y": 2688,
		"type": "POKEBALL"
	},
	{
		"x": 4288,
		"y": 2848,
		"type": "POKEBALL"
	},
	{
		"x": 4480,
		"y": 2560,
		"type": "POKEBALL"
	},
	{
		"x": 4576,
		"y": 2848,
		"type": "POKEBALL"
	}
],
"lastModified": 1730099721315
}