{
"x": 3,
"y": 5,
"biomeType": "PLAINS",
"tileData": [
	[ 1, 1, 1, 10, 10, 1, 1, 1, 10, 1, 1, 1, 10, 1, 10, 10 ],
	[ 1, 1, 1, 1, 1, 1, 10, 1, 1, 10, 1, 1, 1, 10, 10, 1 ],
	[ 10, 1, 1, 1, 1, 1, 1, 1, 1, 1, 1, 1, 1, 1, 10, 1 ],
	[ 1, 10, 1, 1, 10, 1, 1, 1, 1, 1, 1, 1, 10, 10, 10, 1 ],
	[ 1, 1, 1, 1, 1, 1, 1, 1, 10, 1, 1, 1, 1, 10, 1, 1 ],
	[ 1, 1, 1, 10, 10, 1, 1, 1, 10, 1, 1, 1, 1, 10, 1, 10 ],
	[ 1, 1, 1, 1, 10, 10, 1, 1, 10, 1, 1, 1, 1, 1, 1, 1 ],
	[ 1, 10, 1, 1, 1, 1, 1, 1, 1, 1, 1, 1, 1, 10, 1, 1 ],
	[ 1, 1, 1, 1, 1, 10, 1, 1, 1, 1, 1, 1, 1, 1, 1, 1 ],
	[ 1, 1, 1, 1, 1, 1, 10, 10, 1, 1, 1, 1, 10, 1, 1, 1 ],
	[ 1, 1, 1, 1, 1, 10, 10, 1, 1, 1, 1, 1, 1, 1, 10, 10 ],
	[ 1, 10, 1, 1, 1, 1, 1, 1, 1, 1, 10, 1, 1, 1, 1, 1 ],
	[ 1, 1, 1, 1, 10, 1, 1, 1, 1, 1, 1, 10, 10, 1, 1, 1 ],
	[ 1, 1, 1, 1, 1, 1, 1, 1, 1, 1, 1, 1, 1, 1, 1, 1 ],
	[ 1, 10, 1, 1, 1, 1, 1, 1, 10, 1, 1, 1, 1, 1, 1, 1 ],
	[ 10, 1, 1, 1, 1, 1, 1, 1, 1, 1, 1, 10, 1, 10, 1, 1 ]
],
"objects": [
	{
		"x": 1728,
		"y": 2624,
		"type": "POKEBALL"
	},
	{
		"x": 1824,
		"y": 2656,
		"type": "POKEBALL"
	},
	{
		"x": 1952,
		"y": 2880,
		"type": "POKEBALL"
	},
	{
		"x": 1888,
		"y": 2816,
		"type": "POKEBALL"
	},
	{
		"x": 1792,
		"y": 2976,
		"type": "POKEBALL"
	},
	{
		"x": 1568,
		"y": 2560,
		"type": "POKEBALL"
	},
	{
		"x": 1728,
		"y": 3008,
		"type": "POKEBALL"
	},
	{
		"x": 2016,
		"y": 2784,
		"type": "POKEBALL"
	}
],
"lastModified": 1730099716305
}