{
"x": 5,
"y": 6,
"biomeType": "PLAINS",
"tileData": [
	[ 1, 1, 1, 10, 1, 1, 1, 1, 10, 1, 1, 10, 1, 1, 10, 1 ],
	[ 10, 1, 1, 1, 10, 1, 10, 10, 10, 10, 1, 10, 1, 1, 10, 1 ],
	[ 1, 1, 1, 1, 1, 1, 1, 1, 1, 1, 10, 10, 1, 10, 1, 1 ],
	[ 1, 10, 1, 10, 10, 1, 1, 1, 1, 1, 1, 1, 1, 1, 1, 1 ],
	[ 1, 1, 10, 1, 1, 1, 1, 1, 1, 1, 10, 10, 1, 1, 1, 1 ],
	[ 1, 10, 10, 1, 1, 1, 1, 10, 1, 1, 1, 1, 1, 10, 1, 1 ],
	[ 1, 1, 1, 1, 1, 1, 1, 1, 1, 10, 1, 1, 1, 1, 1, 1 ],
	[ 10, 1, 10, 1, 1, 1, 1, 1, 1, 1, 1, 10, 1, 1, 1, 10 ],
	[ 1, 1, 1, 1, 1, 1, 1, 1, 1, 1, 1, 1, 1, 1, 1, 1 ],
	[ 1, 1, 1, 10, 1, 10, 1, 1, 1, 1, 10, 1, 1, 1, 1, 1 ],
	[ 1, 1, 1, 1, 1, 1, 1, 1, 1, 1, 1, 1, 1, 1, 1, 1 ],
	[ 1, 1, 1, 1, 10, 1, 10, 1, 1, 1, 1, 1, 1, 1, 1, 10 ],
	[ 1, 10, 1, 1, 1, 1, 1, 1, 1, 1, 1, 1, 1, 10, 1, 10 ],
	[ 1, 1, 1, 1, 10, 10, 1, 1, 1, 1, 1, 1, 1, 1, 1, 1 ],
	[ 1, 1, 1, 1, 1, 10, 10, 10, 10, 1, 10, 1, 1, 1, 10, 1 ],
	[ 1, 1, 1, 1, 1, 1, 1, 1, 1, 1, 1, 1, 1, 1, 1, 1 ]
],
"objects": [
	{
		"x": 2752,
		"y": 3424,
		"type": "TREE"
	},
	{
		"x": 2880,
		"y": 3168,
		"type": "TREE"
	}
],
"lastModified": 1730100888868
}