{
"x": 7,
"y": 4,
"biomeType": "PLAINS",
"tileData": [
	[ 10, 1, 1, 1, 1, 1, 1, 1, 1, 1, 10, 10, 1, 1, 1, 1 ],
	[ 1, 1, 1, 1, 10, 10, 1, 1, 1, 1, 1, 1, 10, 1, 1, 1 ],
	[ 10, 1, 1, 1, 1, 1, 1, 1, 1, 1, 1, 1, 1, 1, 1, 10 ],
	[ 1, 1, 1, 1, 10, 10, 1, 1, 1, 1, 1, 10, 1, 1, 1, 1 ],
	[ 1, 1, 1, 1, 1, 10, 1, 1, 1, 1, 1, 1, 1, 1, 1, 1 ],
	[ 10, 10, 1, 1, 1, 1, 1, 1, 1, 1, 10, 1, 1, 1, 1, 10 ],
	[ 1, 1, 10, 1, 1, 1, 10, 1, 1, 10, 1, 1, 1, 1, 10, 1 ],
	[ 1, 1, 10, 1, 1, 1, 1, 1, 1, 1, 1, 1, 1, 10, 1, 1 ],
	[ 1, 10, 10, 1, 1, 1, 1, 1, 10, 1, 1, 1, 1, 1, 10, 1 ],
	[ 10, 1, 1, 10, 1, 1, 10, 10, 10, 1, 1, 10, 1, 1, 1, 1 ],
	[ 1, 1, 1, 10, 1, 10, 1, 1, 1, 1, 1, 1, 1, 1, 1, 1 ],
	[ 10, 10, 1, 1, 1, 10, 1, 1, 1, 10, 10, 10, 1, 10, 1, 1 ],
	[ 1, 10, 1, 1, 1, 1, 1, 1, 10, 1, 10, 1, 10, 1, 10, 1 ],
	[ 1, 1, 1, 1, 1, 1, 10, 1, 1, 1, 1, 1, 10, 1, 1, 10 ],
	[ 1, 1, 1, 1, 1, 1, 10, 10, 10, 1, 1, 1, 10, 1, 1, 1 ],
	[ 1, 1, 1, 1, 1, 1, 1, 1, 1, 1, 10, 1, 1, 1, 1, 1 ]
],
"lastModified": 1730099680790
}