{
"x": 12,
"y": -2,
"biomeType": "HAUNTED",
"tileData": [
	[ 7, 7, 5, 5, 9, 7, 5, 5, 7, 5, 5, 5, 5, 5, 7, 5 ],
	[ 7, 5, 5, 9, 5, 7, 7, 5, 7, 9, 5, 5, 5, 5, 5, 9 ],
	[ 5, 9, 5, 5, 5, 5, 5, 5, 9, 9, 5, 5, 5, 5, 9, 5 ],
	[ 7, 7, 5, 9, 5, 5, 5, 5, 5, 7, 5, 7, 5, 5, 5, 5 ],
	[ 5, 9, 5, 9, 5, 5, 5, 5, 7, 5, 5, 5, 9, 5, 9, 9 ],
	[ 5, 5, 7, 5, 5, 7, 5, 5, 5, 8, 5, 8, 8, 5, 5, 5 ],
	[ 7, 7, 5, 9, 9, 5, 5, 5, 7, 9, 5, 7, 9, 8, 5, 8 ],
	[ 5, 9, 5, 5, 9, 5, 5, 9, 9, 5, 5, 5, 5, 7, 9, 5 ],
	[ 5, 9, 7, 5, 5, 5, 5, 9, 5, 5, 5, 7, 5, 5, 5, 7 ],
	[ 5, 5, 5, 5, 5, 9, 7, 5, 9, 5, 8, 5, 5, 5, 5, 9 ],
	[ 5, 9, 5, 5, 9, 5, 5, 5, 9, 5, 5, 5, 9, 5, 5, 8 ],
	[ 5, 9, 9, 5, 9, 5, 5, 5, 5, 5, 9, 5, 9, 5, 5, 5 ],
	[ 5, 8, 5, 5, 9, 9, 9, 9, 5, 9, 8, 5, 8, 9, 8, 9 ],
	[ 9, 8, 9, 5, 5, 5, 9, 5, 5, 7, 5, 5, 5, 5, 5, 5 ],
	[ 5, 5, 9, 7, 9, 5, 5, 9, 5, 5, 5, 5, 5, 9, 9, 5 ],
	[ 5, 5, 5, 5, 5, 5, 5, 5, 5, 9, 5, 5, 5, 8, 8, 5 ]
],
"objects": [
	{
		"x": 6368,
		"y": -800,
		"type": "HAUNTED_TREE"
	}
],
"lastModified": 1730099721310
}