{
"x": 13,
"y": 7,
"biomeType": "PLAINS",
"tileData": [
	[ 1, 1, 1, 10, 1, 1, 1, 1, 1, 1, 10, 1, 10, 1, 1, 10 ],
	[ 10, 10, 10, 1, 1, 1, 1, 1, 1, 1, 1, 1, 1, 1, 10, 1 ],
	[ 1, 10, 10, 1, 1, 1, 1, 1, 1, 1, 1, 1, 1, 1, 1, 1 ],
	[ 1, 1, 1, 1, 1, 10, 1, 10, 1, 1, 1, 1, 1, 1, 10, 1 ],
	[ 1, 1, 10, 10, 1, 1, 1, 1, 1, 10, 1, 10, 10, 1, 10, 1 ],
	[ 1, 1, 10, 1, 1, 1, 1, 1, 10, 1, 1, 10, 1, 1, 1, 10 ],
	[ 1, 1, 1, 10, 1, 1, 1, 1, 1, 1, 1, 10, 1, 1, 1, 1 ],
	[ 1, 1, 1, 1, 1, 1, 1, 1, 1, 1, 1, 1, 10, 1, 1, 1 ],
	[ 1, 10, 1, 1, 1, 1, 1, 10, 10, 1, 1, 1, 1, 1, 1, 1 ],
	[ 1, 10, 1, 1, 1, 1, 1, 1, 10, 10, 1, 1, 1, 1, 1, 1 ],
	[ 1, 1, 1, 1, 1, 1, 10, 1, 1, 1, 1, 1, 1, 1, 1, 1 ],
	[ 1, 10, 1, 1, 1, 1, 10, 1, 1, 1, 1, 1, 1, 1, 1, 1 ],
	[ 1, 1, 1, 1, 1, 1, 1, 1, 10, 1, 10, 1, 10, 1, 1, 1 ],
	[ 1, 1, 1, 10, 1, 1, 1, 1, 10, 1, 1, 1, 10, 1, 1, 10 ],
	[ 1, 1, 1, 1, 1, 1, 1, 10, 1, 1, 1, 1, 1, 10, 1, 1 ],
	[ 1, 1, 1, 1, 10, 1, 1, 1, 1, 1, 1, 1, 1, 10, 1, 1 ]
],
"lastModified": 1730143366384
}