{
"x": 11,
"y": 8,
"biomeType": "PLAINS",
"tileData": [
	[ 1, 1, 1, 1, 1, 1, 1, 1, 1, 10, 10, 10, 1, 10, 1, 1 ],
	[ 1, 1, 1, 1, 1, 1, 1, 1, 1, 10, 10, 1, 1, 1, 10, 1 ],
	[ 1, 10, 1, 1, 1, 10, 1, 1, 1, 1, 1, 1, 1, 10, 1, 1 ],
	[ 10, 1, 1, 1, 1, 1, 1, 1, 1, 10, 1, 1, 1, 1, 1, 1 ],
	[ 1, 1, 1, 1, 1, 1, 1, 1, 10, 1, 1, 1, 1, 1, 1, 1 ],
	[ 1, 10, 1, 1, 1, 1, 1, 1, 10, 1, 1, 1, 10, 1, 10, 1 ],
	[ 1, 1, 10, 1, 1, 1, 1, 1, 1, 10, 10, 1, 1, 1, 10, 1 ],
	[ 1, 1, 1, 10, 1, 1, 1, 1, 1, 1, 1, 10, 1, 10, 1, 10 ],
	[ 1, 1, 1, 1, 1, 1, 1, 1, 1, 1, 1, 1, 10, 1, 1, 1 ],
	[ 1, 1, 1, 10, 1, 1, 1, 1, 1, 1, 1, 10, 1, 1, 1, 1 ],
	[ 1, 1, 1, 1, 1, 1, 1, 10, 1, 1, 1, 10, 1, 1, 10, 10 ],
	[ 1, 10, 1, 1, 1, 1, 1, 1, 1, 1, 10, 1, 1, 10, 10, 1 ],
	[ 10, 10, 1, 10, 1, 1, 10, 1, 1, 1, 1, 1, 1, 1, 1, 1 ],
	[ 10, 1, 1, 1, 1, 1, 1, 1, 10, 1, 1, 1, 1, 1, 1, 1 ],
	[ 10, 10, 1, 1, 1, 1, 10, 1, 1, 10, 1, 10, 1, 1, 10, 1 ],
	[ 1, 10, 1, 1, 1, 1, 1, 1, 1, 1, 1, 10, 1, 1, 10, 1 ]
],
"objects": [
	{
		"x": 5824,
		"y": 4288,
		"type": "TREE"
	}
],
"lastModified": 1730143359947
}