{
"x": 10,
"y": 4,
"biomeType": "PLAINS",
"tileData": [
	[ 1, 1, 1, 1, 1, 10, 1, 1, 1, 1, 1, 10, 1, 10, 1, 10 ],
	[ 1, 1, 1, 1, 1, 1, 1, 10, 10, 1, 10, 10, 1, 1, 1, 10 ],
	[ 1, 1, 1, 10, 1, 1, 1, 1, 10, 1, 1, 1, 10, 1, 10, 1 ],
	[ 1, 1, 1, 10, 1, 1, 1, 1, 1, 1, 1, 1, 1, 1, 1, 1 ],
	[ 1, 10, 10, 1, 1, 1, 1, 10, 1, 10, 1, 1, 10, 1, 1, 1 ],
	[ 1, 1, 1, 10, 10, 1, 1, 1, 10, 1, 1, 1, 1, 1, 1, 1 ],
	[ 1, 10, 10, 10, 1, 1, 10, 1, 1, 1, 1, 1, 10, 1, 1, 10 ],
	[ 1, 10, 1, 1, 10, 1, 1, 1, 1, 10, 1, 1, 1, 1, 1, 1 ],
	[ 1, 1, 1, 1, 1, 1, 1, 1, 10, 1, 1, 1, 1, 1, 1, 1 ],
	[ 1, 1, 10, 1, 1, 1, 1, 1, 1, 1, 1, 1, 10, 1, 1, 1 ],
	[ 1, 1, 1, 1, 10, 1, 1, 10, 1, 1, 1, 1, 1, 10, 1, 1 ],
	[ 1, 1, 1, 1, 1, 10, 1, 1, 1, 1, 1, 1, 1, 1, 1, 1 ],
	[ 1, 1, 10, 1, 10, 1, 1, 1, 10, 1, 1, 1, 1, 1, 1, 1 ],
	[ 10, 1, 10, 1, 1, 1, 1, 10, 1, 1, 1, 1, 1, 1, 1, 1 ],
	[ 1, 1, 1, 1, 1, 1, 1, 1, 1, 1, 10, 1, 10, 1, 1, 10 ],
	[ 1, 10, 1, 1, 10, 1, 1, 1, 1, 1, 10, 10, 10, 1, 1, 1 ]
],
"objects": [
	{
		"x": 5248,
		"y": 2176,
		"type": "TREE"
	}
],
"lastModified": 1730099705801
}