{
"x": 7,
"y": 3,
"biomeType": "PLAINS",
"tileData": [
	[ 1, 10, 1, 1, 1, 10, 1, 1, 1, 1, 10, 1, 10, 1, 1, 1 ],
	[ 10, 1, 1, 1, 1, 1, 10, 1, 10, 1, 10, 1, 1, 1, 1, 1 ],
	[ 1, 1, 10, 1, 1, 1, 1, 1, 10, 10, 1, 10, 1, 1, 1, 1 ],
	[ 1, 10, 1, 1, 1, 1, 10, 10, 10, 1, 1, 1, 1, 10, 1, 1 ],
	[ 1, 10, 10, 1, 1, 1, 1, 10, 10, 1, 1, 10, 10, 1, 1, 1 ],
	[ 1, 1, 10, 1, 1, 1, 1, 1, 1, 1, 10, 1, 1, 1, 1, 1 ],
	[ 1, 1, 1, 1, 1, 1, 1, 1, 10, 10, 1, 1, 10, 1, 1, 1 ],
	[ 1, 10, 1, 1, 1, 10, 1, 1, 10, 1, 1, 1, 10, 1, 10, 1 ],
	[ 1, 1, 1, 1, 10, 1, 1, 1, 1, 10, 10, 1, 1, 1, 1, 1 ],
	[ 1, 1, 1, 1, 10, 1, 1, 1, 1, 1, 1, 1, 1, 1, 10, 1 ],
	[ 1, 1, 10, 1, 1, 1, 1, 1, 1, 1, 1, 1, 1, 1, 1, 1 ],
	[ 1, 1, 1, 1, 1, 10, 10, 1, 1, 1, 1, 1, 1, 10, 1, 1 ],
	[ 10, 1, 10, 1, 1, 1, 1, 1, 1, 1, 1, 1, 1, 1, 1, 1 ],
	[ 10, 1, 1, 10, 1, 1, 1, 1, 1, 10, 1, 1, 1, 1, 1, 1 ],
	[ 10, 10, 1, 1, 1, 1, 1, 10, 1, 1, 1, 10, 1, 1, 1, 1 ],
	[ 10, 1, 10, 1, 10, 1, 1, 1, 1, 1, 1, 1, 1, 1, 1, 1 ]
],
"objects": [
	{
		"x": 3840,
		"y": 1696,
		"type": "TREE"
	}
],
"lastModified": 1730099680788
}