{
"x": 13,
"y": 2,
"biomeType": "PLAINS",
"tileData": [
	[ 1, 1, 1, 10, 10, 1, 1, 1, 1, 1, 1, 1, 1, 1, 1, 1 ],
	[ 1, 1, 1, 1, 1, 1, 1, 1, 1, 1, 1, 1, 1, 1, 1, 1 ],
	[ 1, 1, 10, 1, 10, 10, 10, 1, 1, 1, 1, 1, 10, 1, 1, 1 ],
	[ 10, 10, 1, 1, 10, 1, 1, 1, 1, 1, 1, 1, 1, 1, 10, 1 ],
	[ 1, 1, 10, 10, 10, 1, 1, 1, 1, 1, 10, 1, 10, 1, 1, 1 ],
	[ 1, 1, 1, 1, 1, 1, 1, 10, 10, 1, 10, 1, 1, 1, 1, 10 ],
	[ 1, 1, 1, 1, 1, 1, 1, 1, 10, 10, 1, 1, 1, 1, 1, 1 ],
	[ 1, 1, 10, 1, 1, 1, 1, 1, 1, 10, 1, 10, 1, 10, 1, 1 ],
	[ 1, 1, 1, 1, 1, 1, 1, 1, 1, 1, 10, 1, 1, 1, 1, 1 ],
	[ 1, 1, 1, 10, 1, 1, 1, 1, 1, 1, 1, 1, 1, 1, 1, 1 ],
	[ 1, 1, 10, 1, 1, 1, 1, 1, 1, 1, 1, 10, 1, 10, 1, 1 ],
	[ 1, 1, 1, 10, 1, 1, 10, 1, 1, 1, 1, 10, 1, 1, 1, 1 ],
	[ 10, 1, 1, 1, 1, 1, 1, 10, 1, 1, 1, 1, 1, 1, 1, 1 ],
	[ 1, 1, 1, 1, 1, 1, 1, 1, 1, 1, 10, 1, 10, 1, 10, 1 ],
	[ 1, 1, 1, 1, 10, 1, 1, 10, 1, 10, 1, 1, 1, 1, 1, 10 ],
	[ 1, 1, 10, 1, 1, 1, 1, 1, 1, 10, 10, 10, 1, 1, 1, 1 ]
],
"objects": [
	{
		"x": 6976,
		"y": 1312,
		"type": "TREE"
	}
],
"lastModified": 1730099716299
}