{
"x": 9,
"y": 2,
"biomeType": "PLAINS",
"tileData": [
	[ 10, 1, 1, 1, 10, 1, 10, 1, 1, 1, 1, 1, 1, 1, 1, 1 ],
	[ 10, 1, 1, 1, 1, 1, 1, 1, 1, 10, 1, 1, 1, 10, 1, 1 ],
	[ 10, 10, 1, 10, 1, 1, 1, 1, 1, 1, 1, 1, 10, 10, 10, 1 ],
	[ 1, 1, 1, 1, 1, 1, 1, 1, 1, 10, 10, 1, 1, 10, 1, 1 ],
	[ 1, 10, 1, 1, 1, 1, 1, 1, 1, 1, 1, 1, 1, 1, 1, 1 ],
	[ 10, 1, 1, 1, 10, 10, 10, 1, 1, 10, 1, 1, 1, 10, 1, 1 ],
	[ 10, 1, 10, 10, 1, 1, 1, 1, 1, 1, 10, 1, 10, 1, 1, 1 ],
	[ 1, 1, 1, 1, 10, 1, 1, 1, 10, 1, 10, 1, 1, 1, 1, 10 ],
	[ 1, 1, 1, 10, 10, 1, 1, 1, 1, 10, 1, 10, 1, 1, 1, 1 ],
	[ 1, 1, 1, 1, 1, 1, 1, 1, 1, 1, 1, 1, 1, 10, 1, 10 ],
	[ 1, 1, 1, 1, 1, 10, 1, 1, 1, 1, 1, 1, 1, 1, 10, 10 ],
	[ 1, 1, 1, 1, 1, 1, 1, 1, 1, 1, 1, 10, 1, 1, 10, 1 ],
	[ 1, 1, 1, 1, 1, 1, 1, 1, 10, 1, 10, 1, 10, 1, 10, 1 ],
	[ 1, 1, 1, 1, 1, 1, 1, 1, 1, 1, 1, 1, 1, 1, 1, 1 ],
	[ 1, 1, 10, 1, 10, 1, 10, 1, 10, 1, 1, 1, 1, 1, 1, 1 ],
	[ 1, 1, 1, 1, 1, 1, 1, 1, 1, 1, 1, 10, 1, 10, 1, 1 ]
],
"objects": [
	{
		"x": 4736,
		"y": 1216,
		"type": "TREE"
	}
],
"lastModified": 1730099682213
}