{
"x": 6,
"y": 7,
"biomeType": "PLAINS",
"tileData": [
	[ 10, 1, 1, 1, 1, 10, 1, 1, 1, 1, 1, 1, 1, 1, 1, 10 ],
	[ 1, 1, 1, 1, 1, 1, 1, 10, 1, 1, 1, 1, 1, 1, 1, 1 ],
	[ 1, 1, 1, 10, 10, 1, 1, 1, 10, 1, 1, 1, 10, 1, 1, 1 ],
	[ 10, 1, 1, 10, 1, 1, 1, 1, 1, 1, 1, 1, 1, 1, 1, 1 ],
	[ 1, 1, 1, 1, 1, 1, 10, 1, 1, 10, 1, 1, 1, 1, 1, 1 ],
	[ 1, 1, 1, 1, 1, 10, 1, 1, 10, 1, 1, 10, 10, 1, 1, 1 ],
	[ 1, 1, 1, 10, 1, 10, 1, 10, 10, 1, 10, 1, 1, 1, 1, 1 ],
	[ 1, 1, 1, 10, 1, 1, 1, 1, 1, 1, 1, 1, 1, 1, 1, 1 ],
	[ 1, 1, 1, 1, 1, 1, 10, 1, 1, 1, 1, 1, 1, 10, 1, 1 ],
	[ 1, 1, 1, 1, 10, 1, 1, 1, 1, 1, 1, 1, 1, 1, 1, 1 ],
	[ 1, 1, 1, 1, 1, 10, 1, 1, 10, 1, 1, 1, 1, 1, 1, 1 ],
	[ 10, 1, 1, 1, 10, 1, 1, 1, 1, 10, 10, 1, 1, 1, 1, 10 ],
	[ 1, 1, 10, 1, 1, 1, 1, 1, 10, 1, 1, 10, 1, 1, 1, 1 ],
	[ 1, 1, 1, 10, 10, 1, 1, 1, 1, 1, 10, 1, 10, 1, 1, 10 ],
	[ 1, 10, 10, 1, 1, 1, 10, 10, 1, 10, 1, 1, 10, 1, 1, 1 ],
	[ 1, 1, 10, 1, 1, 1, 1, 1, 1, 1, 1, 1, 10, 1, 10, 1 ]
],
"lastModified": 1730120465258
}