{
"x": -45,
"y": -3,
"biomeType": "FOREST",
"tileData": [
	[ 55, 56, 1, 54, 1, 1, 1, 10, 10, 1, 1, 10, 11, 1, 10, 12 ],
	[ 10, 1, 10, 1, 10, 1, 1, 1, 1, 1, 24, 11, 11, 1, 11, 11 ],
	[ 1, 10, 56, 1, 10, 1, 1, 1, 1, 1, 11, 11, 1, 12, 11, 12 ],
	[ 10, 56, 1, 10, 24, 10, 1, 10, 10, 11, 24, 12, 1, 11, 11, 12 ],
	[ 1, 10, 1, 1, 1, 1, 1, 22, 1, 1, 11, 12, 11, 12, 11, 12 ],
	[ 24, 1, 10, 10, 10, 10, 24, 11, 1, 12, 10, 11, 12, 11, 11, 12 ],
	[ 24, 24, 1, 1, 1, 10, 10, 10, 1, 11, 11, 1, 12, 11, 12, 12 ],
	[ 1, 10, 1, 10, 10, 10, 11, 22, 12, 11, 1, 11, 11, 11, 1, 10 ],
	[ 10, 1, 10, 10, 1, 1, 10, 11, 11, 11, 11, 1, 11, 12, 11, 11 ],
	[ 1, 1, 1, 12, 11, 12, 10, 12, 12, 1, 12, 12, 10, 11, 11, 12 ],
	[ 1, 24, 11, 11, 1, 1, 11, 12, 12, 1, 10, 11, 11, 11, 11, 1 ],
	[ 1, 10, 1, 10, 10, 11, 1, 12, 11, 1, 12, 11, 11, 1, 11, 11 ],
	[ 11, 12, 10, 10, 11, 12, 12, 11, 12, 12, 11, 11, 11, 10, 1, 11 ],
	[ 12, 1, 20, 12, 12, 12, 1, 11, 12, 11, 11, 12, 12, 20, 1, 1 ],
	[ 11, 10, 11, 1, 11, 11, 10, 12, 12, 11, 11, 1, 11, 10, 1, 11 ],
	[ 12, 11, 11, 1, 1, 11, 11, 11, 11, 12, 20, 1, 10, 10, 11, 11 ]
],
"objects": [
	{
		"class": "io.github.pokemeetup.system.gameplay.overworld.World$WorldObjectData",
		"x": -23040,
		"y": -1536,
		"type": "RUINS_TREE"
	},
	{
		"class": "io.github.pokemeetup.system.gameplay.overworld.World$WorldObjectData",
		"x": -22976,
		"y": -1472,
		"type": "RUIN_POLE"
	},
	{
		"class": "io.github.pokemeetup.system.gameplay.overworld.World$WorldObjectData",
		"x": -22848,
		"y": -1408,
		"type": "POKEBALL"
	}
],
"blocks": [],
"lastModified": 0,
"isMultiplayer": false
}