{
"x": -44,
"y": 3,
"biomeType": "SNOW",
"tileData": [
	[ 1, 1, 1, 1, 10, 1, 51, 4, 4, 4, 4, 6, 4, 9, 5, 5 ],
	[ 1, 1, 10, 1, 1, 4, 6, 6, 6, 52, 4, 4, 4, 7, 5, 5 ],
	[ 1, 1, 1, 10, 1, 4, 4, 4, 51, 51, 4, 4, 5, 5, 5, 5 ],
	[ 24, 10, 1, 10, 4, 52, 4, 51, 4, 4, 4, 9, 5, 9, 5, 7 ],
	[ 1, 1, 24, 4, 4, 4, 4, 4, 4, 51, 4, 5, 5, 8, 1, 5 ],
	[ 10, 10, 10, 4, 206, 203, 203, 203, 203, 203, 203, 203, 200, 7, 5, 7 ],
	[ 22, 10, 206, 203, 204, 204, 204, 204, 204, 204, 204, 204, 204, 203, 200, 5 ],
	[ 1, 4, 207, 204, 204, 204, 204, 204, 204, 204, 204, 204, 204, 204, 204, 200 ],
	[ 1, 206, 204, 204, 204, 204, 204, 204, 204, 204, 204, 204, 204, 204, 204, 201 ],
	[ 4, 207, 204, 204, 204, 204, 204, 204, 204, 204, 204, 204, 204, 204, 204, 201 ],
	[ 51, 208, 204, 204, 204, 204, 204, 204, 204, 204, 204, 204, 204, 204, 204, 201 ],
	[ 52, 6, 207, 204, 204, 204, 204, 204, 204, 204, 204, 204, 204, 204, 204, 202 ],
	[ 52, 4, 207, 204, 204, 204, 204, 204, 204, 204, 204, 204, 204, 204, 202, 51 ],
	[ 4, 4, 208, 204, 204, 204, 204, 204, 204, 204, 205, 205, 205, 202, 6, 4 ],
	[ 4, 4, 4, 208, 204, 204, 204, 205, 205, 202, 7, 7, 7, 7, 51, 4 ],
	[ 51, 4, 4, 51, 208, 205, 202, 5, 5, 8, 9, 7, 7, 4, 4, 4 ]
],
"objects": [
	{
		"class": "io.github.pokemeetup.system.gameplay.overworld.World$WorldObjectData",
		"x": -22272,
		"y": 1536,
		"type": "TREE_0"
	},
	{
		"class": "io.github.pokemeetup.system.gameplay.overworld.World$WorldObjectData",
		"x": -22528,
		"y": 1600,
		"type": "TREE_0"
	},
	{
		"class": "io.github.pokemeetup.system.gameplay.overworld.World$WorldObjectData",
		"x": -22400,
		"y": 1568,
		"type": "TREE_0"
	},
	{
		"class": "io.github.pokemeetup.system.gameplay.overworld.World$WorldObjectData",
		"x": -22464,
		"y": 1536,
		"type": "POKEBALL"
	}
],
"blocks": [],
"lastModified": 0,
"isMultiplayer": false
}