{
"x": -44,
"y": 4,
"biomeType": "SNOW",
"tileData": [
	[ 5, 5, 5, 5, 5, 4, 4, 4, 52, 4, 4, 6, 4, 4, 4, 4 ],
	[ 7, 5, 5, 7, 4, 4, 4, 4, 6, 6, 4, 4, 4, 4, 4, 4 ],
	[ 8, 9, 5, 7, 4, 4, 51, 4, 4, 51, 4, 4, 4, 4, 4, 4 ],
	[ 7, 8, 7, 4, 4, 4, 4, 4, 4, 4, 4, 4, 6, 4, 4, 4 ],
	[ 9, 5, 5, 6, 4, 4, 6, 4, 4, 4, 4, 4, 4, 4, 4, 4 ],
	[ 5, 5, 4, 4, 4, 51, 51, 6, 4, 51, 4, 4, 4, 4, 4, 4 ],
	[ 5, 5, 51, 4, 4, 4, 4, 4, 4, 51, 4, 51, 4, 4, 4, 4 ],
	[ 5, 6, 6, 4, 4, 52, 4, 4, 4, 4, 4, 4, 4, 4, 4, 4 ],
	[ 7, 4, 4, 4, 4, 4, 4, 4, 51, 4, 52, 4, 4, 4, 51, 4 ],
	[ 4, 6, 51, 4, 6, 4, 6, 4, 51, 6, 4, 4, 4, 51, 52, 51 ],
	[ 4, 4, 4, 4, 4, 4, 4, 4, 51, 4, 52, 4, 51, 4, 6, 4 ],
	[ 4, 51, 4, 4, 4, 51, 4, 4, 6, 4, 4, 4, 4, 4, 52, 4 ],
	[ 4, 4, 4, 6, 4, 4, 4, 4, 4, 4, 4, 4, 4, 6, 4, 4 ],
	[ 4, 52, 4, 4, 4, 4, 6, 4, 4, 51, 51, 4, 52, 4, 4, 4 ],
	[ 4, 4, 6, 4, 6, 6, 4, 4, 51, 4, 4, 4, 6, 4, 4, 4 ],
	[ 4, 4, 4, 51, 4, 4, 4, 4, 6, 4, 51, 4, 4, 4, 6, 6 ]
],
"objects": [
	{
		"class": "io.github.pokemeetup.system.gameplay.overworld.World$WorldObjectData",
		"x": -22272,
		"y": 2048,
		"type": "HAUNTED_TREE"
	},
	{
		"class": "io.github.pokemeetup.system.gameplay.overworld.World$WorldObjectData",
		"x": -22528,
		"y": 2112,
		"type": "HAUNTED_TREE"
	},
	{
		"class": "io.github.pokemeetup.system.gameplay.overworld.World$WorldObjectData",
		"x": -22400,
		"y": 2080,
		"type": "HAUNTED_TREE"
	}
],
"blocks": [],
"lastModified": 0,
"isMultiplayer": false
}