{
"x": -44,
"y": 0,
"biomeType": "SNOW",
"tileData": [
	[ 207, 203, 203, 201, 4, 4, 52, 4, 5, 5, 5, 5, 7, 7, 4, 4 ],
	[ 4, 4, 4, 6, 201, 4, 4, 4, 52, 5, 9, 9, 7, 5, 9, 4 ],
	[ 6, 4, 4, 206, 201, 4, 4, 4, 4, 5, 5, 7, 5, 7, 5, 4 ],
	[ 4, 206, 203, 204, 204, 203, 200, 6, 4, 9, 5, 9, 5, 5, 8, 5 ],
	[ 4, 207, 204, 204, 204, 204, 204, 200, 4, 4, 5, 5, 5, 5, 5, 7 ],
	[ 206, 204, 204, 204, 204, 204, 204, 201, 4, 4, 5, 5, 9, 5, 5, 7 ],
	[ 207, 204, 204, 204, 204, 204, 204, 204, 200, 4, 4, 5, 7, 7, 5, 5 ],
	[ 207, 204, 204, 204, 204, 204, 204, 204, 201, 4, 51, 7, 8, 5, 5, 9 ],
	[ 207, 204, 204, 204, 204, 204, 204, 204, 202, 51, 4, 4, 9, 5, 5, 7 ],
	[ 207, 204, 204, 204, 204, 204, 204, 201, 4, 4, 4, 51, 5, 5, 5, 9 ],
	[ 207, 204, 204, 204, 204, 204, 204, 201, 4, 4, 4, 4, 4, 7, 5, 5 ],
	[ 208, 204, 204, 204, 204, 204, 204, 201, 4, 4, 4, 4, 51, 4, 5, 5 ],
	[ 6, 207, 204, 204, 204, 204, 204, 201, 6, 4, 52, 4, 4, 52, 8, 5 ],
	[ 4, 207, 204, 204, 204, 204, 204, 202, 4, 51, 52, 6, 51, 4, 52, 7 ],
	[ 4, 208, 204, 204, 204, 205, 202, 4, 4, 4, 4, 51, 51, 4, 4, 5 ],
	[ 4, 4, 208, 205, 202, 4, 4, 4, 4, 4, 4, 4, 4, 4, 52, 4 ]
],
"objects": [
	{
		"class": "io.github.pokemeetup.system.gameplay.overworld.World$WorldObjectData",
		"x": -22272,
		"y": 288,
		"type": "SNOW_TREE"
	},
	{
		"class": "io.github.pokemeetup.system.gameplay.overworld.World$WorldObjectData",
		"x": -22176,
		"y": 320,
		"type": "SNOW_TREE"
	},
	{
		"class": "io.github.pokemeetup.system.gameplay.overworld.World$WorldObjectData",
		"x": -22080,
		"y": 256,
		"type": "SNOW_TREE"
	},
	{
		"class": "io.github.pokemeetup.system.gameplay.overworld.World$WorldObjectData",
		"x": -22048,
		"y": 352,
		"type": "SNOW_TREE"
	}
],
"blocks": [],
"lastModified": 0,
"isMultiplayer": false
}