{
"x": -48,
"y": -3,
"biomeType": "RUINS",
"tileData": [
	[ 54, 56, 56, 53, 54, 55, 54, 54, 56, 54, 56, 56, 55, 53, 56, 56 ],
	[ 56, 54, 55, 56, 56, 56, 56, 56, 56, 54, 55, 56, 54, 56, 56, 56 ],
	[ 56, 56, 53, 54, 56, 53, 56, 54, 53, 54, 55, 54, 54, 56, 56, 56 ],
	[ 56, 56, 56, 56, 56, 56, 56, 53, 54, 55, 56, 56, 56, 56, 56, 56 ],
	[ 56, 56, 56, 54, 56, 56, 55, 54, 55, 53, 53, 56, 53, 53, 54, 53 ],
	[ 56, 56, 56, 56, 55, 56, 56, 56, 56, 56, 56, 56, 56, 56, 56, 56 ],
	[ 56, 56, 56, 56, 56, 54, 56, 56, 56, 56, 54, 56, 54, 55, 56, 56 ],
	[ 54, 56, 54, 56, 56, 56, 56, 56, 56, 54, 56, 56, 53, 53, 56, 56 ],
	[ 56, 53, 55, 56, 54, 55, 56, 56, 54, 54, 56, 54, 54, 56, 56, 54 ],
	[ 54, 55, 56, 56, 55, 54, 56, 56, 55, 54, 56, 53, 55, 56, 53, 53 ],
	[ 56, 53, 56, 55, 54, 56, 56, 55, 54, 53, 56, 56, 56, 56, 54, 56 ],
	[ 56, 55, 55, 56, 56, 56, 55, 54, 56, 54, 56, 56, 55, 56, 56, 54 ],
	[ 54, 54, 56, 56, 56, 56, 54, 54, 56, 56, 56, 56, 56, 56, 56, 22 ],
	[ 56, 56, 56, 54, 53, 54, 56, 55, 56, 56, 54, 55, 56, 55, 55, 10 ],
	[ 54, 56, 56, 56, 54, 54, 56, 55, 56, 56, 53, 56, 56, 56, 56, 1 ],
	[ 56, 56, 54, 56, 53, 54, 56, 56, 56, 56, 56, 54, 56, 55, 1, 53 ]
],
"objects": [
	{
		"class": "io.github.pokemeetup.system.gameplay.overworld.World$WorldObjectData",
		"x": -24096,
		"y": -1088,
		"type": "HAUNTED_TREE"
	}
],
"blocks": [],
"lastModified": 0,
"isMultiplayer": false
}