{
"x": -46,
"y": -4,
"biomeType": "RUINS",
"tileData": [
	[ 5, 7, 7, 56, 56, 54, 56, 55, 56, 56, 56, 56, 56, 56, 54, 56 ],
	[ 5, 5, 56, 55, 56, 56, 56, 56, 55, 55, 55, 54, 56, 56, 56, 55 ],
	[ 5, 5, 56, 56, 56, 56, 55, 56, 53, 56, 55, 56, 56, 56, 54, 56 ],
	[ 5, 55, 56, 56, 54, 56, 54, 56, 56, 56, 56, 56, 55, 54, 56, 56 ],
	[ 5, 53, 56, 56, 55, 56, 56, 56, 56, 56, 54, 56, 56, 56, 56, 56 ],
	[ 54, 56, 5, 56, 56, 56, 54, 54, 56, 56, 56, 56, 54, 54, 55, 56 ],
	[ 56, 56, 55, 53, 56, 56, 56, 56, 54, 55, 56, 56, 56, 56, 56, 56 ],
	[ 56, 56, 55, 56, 56, 54, 56, 53, 56, 56, 53, 53, 54, 56, 56, 56 ],
	[ 56, 53, 56, 56, 56, 56, 53, 56, 53, 54, 55, 54, 56, 56, 56, 56 ],
	[ 56, 56, 56, 54, 56, 56, 56, 56, 56, 56, 54, 56, 56, 56, 54, 56 ],
	[ 54, 56, 56, 56, 54, 56, 55, 53, 56, 56, 56, 56, 56, 55, 56, 55 ],
	[ 56, 56, 56, 54, 56, 53, 54, 56, 56, 56, 53, 55, 53, 56, 56, 56 ],
	[ 54, 56, 56, 56, 56, 56, 54, 56, 56, 56, 55, 56, 56, 56, 55, 56 ],
	[ 56, 56, 56, 53, 56, 56, 56, 56, 53, 55, 56, 53, 56, 56, 56, 56 ],
	[ 56, 55, 56, 56, 55, 56, 56, 54, 56, 54, 56, 53, 53, 56, 56, 56 ],
	[ 55, 56, 56, 56, 56, 56, 56, 56, 53, 56, 56, 54, 56, 54, 55, 56 ]
],
"objects": [],
"blocks": [],
"lastModified": 0,
"isMultiplayer": false
}