{
"x": -47,
"y": -2,
"biomeType": "FOREST",
"tileData": [
	[ 1, 1, 1, 1, 1, 10, 1, 1, 1, 10, 12, 11, 12, 12, 11, 11 ],
	[ 24, 22, 10, 1, 1, 24, 1, 10, 1, 11, 11, 11, 12, 11, 1, 1 ],
	[ 24, 1, 1, 1, 10, 24, 1, 24, 10, 1, 10, 1, 10, 12, 12, 10 ],
	[ 1, 1, 1, 1, 10, 24, 10, 11, 1, 1, 11, 11, 11, 12, 11, 11 ],
	[ 1, 10, 1, 1, 10, 1, 1, 11, 10, 11, 12, 11, 11, 12, 11, 11 ],
	[ 10, 1, 10, 1, 10, 10, 11, 1, 10, 11, 12, 1, 11, 11, 11, 11 ],
	[ 24, 1, 1, 24, 1, 10, 12, 10, 11, 11, 11, 10, 11, 12, 11, 11 ],
	[ 1, 1, 1, 10, 10, 10, 1, 11, 1, 1, 11, 12, 11, 12, 11, 12 ],
	[ 1, 1, 1, 1, 10, 11, 1, 10, 10, 12, 11, 12, 11, 11, 1, 10 ],
	[ 24, 10, 1, 1, 10, 12, 10, 24, 11, 11, 11, 12, 12, 12, 12, 10 ],
	[ 1, 1, 1, 1, 1, 11, 1, 12, 11, 12, 1, 12, 11, 1, 11, 11 ],
	[ 1, 1, 10, 10, 1, 24, 1, 11, 1, 12, 11, 20, 1, 20, 11, 11 ],
	[ 1, 10, 10, 10, 10, 1, 11, 12, 1, 11, 12, 12, 11, 11, 11, 12 ],
	[ 24, 1, 1, 1, 1, 1, 1, 10, 11, 11, 12, 1, 12, 12, 11, 1 ],
	[ 10, 10, 10, 10, 10, 1, 12, 11, 11, 10, 11, 11, 10, 11, 12, 11 ],
	[ 10, 1, 10, 1, 10, 12, 11, 12, 1, 11, 11, 11, 11, 11, 10, 1 ]
],
"objects": [
	{
		"class": "io.github.pokemeetup.system.gameplay.overworld.World$WorldObjectData",
		"x": -24032,
		"y": -576,
		"type": "POKEBALL"
	}
],
"blocks": [],
"lastModified": 0,
"isMultiplayer": false
}