{
"x": -32,
"y": 4,
"biomeType": "FOREST",
"tileData": [
	[ 51, 4, 4, 4, 4, 51, 6, 4, 11, 4, 4, 4, 11, 11, 12, 20 ],
	[ 4, 4, 4, 4, 4, 6, 6, 4, 4, 4, 52, 12, 11, 12, 11, 11 ],
	[ 6, 4, 4, 51, 4, 4, 4, 4, 4, 12, 11, 1, 12, 1, 11, 11 ],
	[ 4, 4, 12, 4, 20, 4, 4, 12, 1, 12, 11, 10, 11, 11, 20, 12 ],
	[ 51, 1, 4, 6, 11, 11, 11, 10, 11, 12, 11, 12, 11, 12, 12, 11 ],
	[ 52, 11, 4, 4, 11, 11, 11, 12, 11, 12, 1, 11, 11, 12, 12, 10 ],
	[ 4, 12, 12, 11, 11, 11, 11, 1, 11, 11, 11, 11, 12, 1, 11, 12 ],
	[ 1, 10, 11, 12, 11, 12, 11, 12, 12, 11, 11, 12, 12, 12, 1, 12 ],
	[ 1, 11, 20, 12, 20, 11, 10, 11, 11, 11, 10, 11, 1, 10, 10, 11 ],
	[ 11, 11, 1, 10, 11, 11, 10, 11, 11, 11, 12, 1, 1, 1, 11, 1 ],
	[ 11, 1, 10, 11, 12, 12, 11, 11, 1, 10, 12, 11, 11, 11, 11, 1 ],
	[ 12, 11, 11, 11, 12, 11, 12, 11, 20, 11, 10, 12, 11, 11, 1, 10 ],
	[ 1, 12, 11, 1, 11, 11, 11, 12, 1, 1, 10, 11, 12, 12, 11, 12 ],
	[ 10, 12, 11, 11, 12, 11, 12, 11, 12, 12, 11, 1, 12, 11, 11, 12 ],
	[ 10, 20, 11, 11, 11, 1, 11, 12, 11, 11, 11, 1, 11, 11, 11, 1 ],
	[ 11, 11, 12, 12, 12, 12, 10, 11, 11, 11, 11, 11, 11, 1, 12, 11 ]
],
"objects": [
	{
		"class": "io.github.pokemeetup.system.gameplay.overworld.World$WorldObjectData",
		"x": -16384,
		"y": 2112,
		"type": "SNOW_TREE"
	},
	{
		"class": "io.github.pokemeetup.system.gameplay.overworld.World$WorldObjectData",
		"x": -16384,
		"y": 2240,
		"type": "SNOW_TREE"
	},
	{
		"class": "io.github.pokemeetup.system.gameplay.overworld.World$WorldObjectData",
		"x": -16288,
		"y": 2304,
		"type": "POKEBALL"
	}
],
"blocks": [],
"lastModified": 0,
"isMultiplayer": false
}