{
"x": -31,
"y": 3,
"biomeType": "FOREST",
"tileData": [
	[ 4, 51, 4, 11, 11, 12, 1, 11, 1, 11, 20, 12, 1, 11, 12, 11 ],
	[ 4, 6, 20, 11, 1, 11, 12, 11, 11, 11, 1, 11, 11, 11, 11, 11 ],
	[ 4, 11, 11, 1, 11, 11, 12, 11, 11, 12, 12, 11, 11, 11, 11, 20 ],
	[ 11, 11, 20, 11, 10, 1, 11, 11, 12, 11, 11, 12, 11, 11, 11, 12 ],
	[ 12, 12, 11, 12, 11, 11, 11, 1, 11, 11, 12, 20, 11, 11, 1, 11 ],
	[ 11, 1, 11, 12, 11, 11, 1, 12, 11, 12, 11, 11, 11, 12, 12, 10 ],
	[ 12, 10, 11, 11, 11, 12, 12, 12, 11, 1, 11, 11, 11, 11, 20, 11 ],
	[ 1, 10, 12, 11, 11, 12, 11, 12, 11, 11, 11, 12, 12, 12, 11, 11 ],
	[ 1, 11, 11, 11, 12, 11, 1, 12, 11, 11, 1, 11, 11, 12, 12, 11 ],
	[ 11, 11, 12, 1, 11, 11, 12, 11, 12, 12, 12, 11, 10, 1, 11, 11 ],
	[ 20, 11, 11, 11, 12, 20, 11, 20, 12, 12, 11, 12, 12, 11, 11, 12 ],
	[ 1, 10, 12, 12, 1, 11, 12, 12, 11, 11, 12, 10, 11, 11, 12, 11 ],
	[ 20, 11, 12, 11, 12, 11, 12, 11, 12, 12, 12, 11, 1, 12, 12, 11 ],
	[ 11, 12, 12, 11, 20, 11, 12, 1, 12, 11, 11, 11, 12, 11, 140, 12 ],
	[ 11, 11, 11, 11, 1, 10, 12, 1, 1, 11, 140, 13, 11, 13, 12, 1 ],
	[ 12, 11, 20, 12, 12, 12, 12, 10, 11, 10, 1, 14, 1, 1, 13, 13 ]
],
"objects": [
	{
		"class": "io.github.pokemeetup.system.gameplay.overworld.World$WorldObjectData",
		"x": -15872,
		"y": 1600,
		"type": "SNOW_TREE"
	},
	{
		"class": "io.github.pokemeetup.system.gameplay.overworld.World$WorldObjectData",
		"x": -15872,
		"y": 1792,
		"type": "POKEBALL"
	}
],
"blocks": [],
"lastModified": 0,
"isMultiplayer": false
}