{
"x": 1,
"y": -1,
"biomeType": "PLAINS",
"tileData": [
	[ 1, 1, 10, 1, 1, 1, 1, 10, 1, 1, 1, 1, 10, 1, 1, 1 ],
	[ 1, 1, 1, 1, 1, 1, 1, 1, 10, 10, 1, 1, 1, 1, 10, 1 ],
	[ 1, 1, 1, 1, 1, 1, 1, 1, 10, 1, 1, 1, 1, 10, 1, 10 ],
	[ 1, 1, 1, 1, 10, 10, 1, 1, 1, 1, 1, 1, 10, 1, 10, 1 ],
	[ 1, 1, 1, 1, 1, 1, 1, 1, 1, 1, 1, 10, 1, 10, 1, 10 ],
	[ 1, 1, 1, 1, 1, 1, 1, 1, 1, 1, 1, 1, 1, 1, 1, 10 ],
	[ 1, 1, 1, 1, 10, 10, 1, 10, 1, 1, 1, 1, 1, 1, 1, 1 ],
	[ 1, 10, 1, 1, 1, 1, 1, 1, 10, 1, 1, 1, 1, 1, 1, 10 ],
	[ 1, 1, 1, 10, 1, 1, 1, 1, 1, 1, 1, 1, 1, 10, 1, 1 ],
	[ 1, 1, 1, 1, 1, 10, 10, 1, 1, 10, 1, 1, 1, 1, 1, 10 ],
	[ 1, 10, 1, 1, 10, 1, 1, 10, 1, 10, 1, 10, 1, 1, 1, 1 ],
	[ 10, 1, 1, 1, 1, 1, 1, 1, 10, 1, 1, 10, 1, 1, 1, 1 ],
	[ 10, 10, 1, 1, 1, 1, 10, 1, 10, 1, 1, 1, 1, 10, 1, 10 ],
	[ 1, 1, 10, 1, 1, 1, 1, 10, 1, 1, 1, 1, 1, 1, 1, 1 ],
	[ 1, 10, 1, 10, 1, 1, 1, 1, 10, 1, 10, 1, 1, 1, 1, 1 ],
	[ 1, 1, 1, 1, 1, 1, 10, 1, 1, 1, 1, 1, 1, 1, 1, 1 ]
],
"objects": [
	{
		"x": 704,
		"y": -192,
		"type": "TREE"
	}
],
"lastModified": 1730368306163
}