{
"x": 2,
"y": 1,
"biomeType": "PLAINS",
"tileData": [
	[ 1, 10, 1, 1, 1, 10, 1, 1, 10, 1, 1, 1, 1, 10, 10, 1 ],
	[ 1, 1, 10, 1, 10, 1, 1, 10, 1, 1, 1, 1, 1, 1, 1, 10 ],
	[ 10, 1, 10, 1, 1, 1, 1, 1, 1, 1, 1, 1, 1, 1, 1, 1 ],
	[ 1, 1, 1, 1, 1, 1, 1, 1, 1, 10, 1, 10, 10, 1, 10, 1 ],
	[ 1, 10, 1, 1, 1, 1, 1, 1, 1, 10, 1, 10, 1, 10, 1, 1 ],
	[ 1, 1, 1, 1, 1, 1, 1, 1, 1, 10, 1, 1, 1, 1, 1, 1 ],
	[ 10, 10, 1, 1, 1, 1, 1, 1, 1, 1, 1, 1, 1, 1, 1, 10 ],
	[ 1, 1, 1, 1, 10, 1, 1, 1, 1, 1, 1, 10, 1, 1, 1, 1 ],
	[ 1, 1, 1, 1, 1, 1, 10, 1, 10, 10, 1, 1, 1, 1, 1, 10 ],
	[ 1, 1, 1, 1, 1, 1, 1, 1, 1, 1, 1, 1, 1, 1, 1, 1 ],
	[ 1, 1, 10, 1, 1, 1, 1, 1, 1, 1, 1, 1, 1, 1, 1, 1 ],
	[ 10, 1, 1, 1, 1, 10, 1, 10, 1, 1, 1, 1, 1, 1, 1, 1 ],
	[ 1, 1, 1, 1, 1, 1, 1, 1, 10, 1, 1, 1, 1, 1, 1, 1 ],
	[ 1, 1, 1, 1, 1, 1, 1, 1, 10, 10, 1, 1, 1, 1, 1, 1 ],
	[ 1, 1, 1, 1, 10, 1, 1, 1, 1, 10, 1, 10, 1, 1, 1, 10 ],
	[ 1, 1, 1, 1, 1, 10, 1, 10, 10, 10, 1, 1, 1, 1, 1, 1 ]
],
"objects": [
	{
		"x": 1152,
		"y": 768,
		"type": "TREE"
	}
],
"lastModified": 1730368306173
}