{
"y": 1,
"biomeType": "PLAINS",
"tileData": [
	[ 1, 1, 1, 1, 1, 10, 1, 1, 1, 1, 1, 1, 1, 10, 1, 10 ],
	[ 1, 1, 1, 1, 1, 1, 1, 1, 1, 1, 1, 1, 1, 1, 1, 10 ],
	[ 1, 1, 1, 1, 1, 10, 1, 1, 1, 10, 1, 1, 10, 1, 1, 1 ],
	[ 1, 1, 1, 1, 1, 1, 1, 10, 1, 1, 1, 1, 1, 1, 1, 10 ],
	[ 1, 1, 1, 1, 1, 1, 1, 1, 1, 1, 1, 1, 1, 1, 1, 1 ],
	[ 1, 1, 1, 10, 10, 1, 10, 1, 1, 1, 1, 1, 1, 1, 1, 1 ],
	[ 1, 1, 1, 1, 1, 1, 1, 1, 1, 1, 1, 1, 1, 1, 1, 1 ],
	[ 1, 10, 1, 10, 1, 1, 1, 1, 10, 10, 1, 10, 1, 1, 10, 10 ],
	[ 1, 1, 1, 1, 1, 1, 1, 1, 1, 1, 1, 1, 10, 10, 1, 1 ],
	[ 10, 1, 1, 1, 1, 10, 1, 10, 1, 1, 1, 1, 1, 1, 10, 1 ],
	[ 1, 1, 1, 10, 1, 1, 1, 1, 1, 10, 1, 1, 10, 1, 10, 1 ],
	[ 1, 1, 1, 1, 1, 1, 1, 1, 1, 1, 10, 1, 1, 1, 10, 1 ],
	[ 1, 1, 1, 1, 1, 10, 10, 1, 10, 1, 1, 10, 1, 10, 1, 1 ],
	[ 1, 1, 1, 1, 1, 1, 10, 1, 1, 1, 10, 1, 10, 1, 1, 1 ],
	[ 10, 1, 1, 1, 10, 1, 1, 1, 1, 1, 10, 1, 1, 1, 1, 10 ],
	[ 1, 1, 1, 10, 1, 1, 10, 1, 1, 1, 1, 1, 1, 1, 10, 1 ]
],
"objects": [
	{
		"x": 64,
		"y": 800,
		"type": "TREE"
	}
],
"lastModified": 1730368306161
}