{
"x": 3,
"y": -3,
"biomeType": "PLAINS",
"tileData": [
	[ 1, 1, 1, 1, 10, 1, 206, 203, 203, 203, 203, 203, 200, 1, 10, 10 ],
	[ 1, 24, 1, 1, 206, 235, 204, 204, 206, 203, 200, 204, 201, 1, 1, 1 ],
	[ 24, 10, 206, 203, 204, 206, 203, 203, 204, 204, 204, 200, 204, 200, 10, 10 ],
	[ 206, 203, 204, 204, 206, 204, 204, 206, 203, 200, 204, 204, 200, 204, 200, 1 ],
	[ 207, 204, 204, 206, 204, 206, 203, 204, 204, 204, 200, 204, 201, 204, 201, 1 ],
	[ 207, 204, 206, 204, 206, 204, 204, 204, 204, 204, 204, 200, 235, 200, 204, 200 ],
	[ 207, 206, 204, 206, 204, 204, 204, 204, 204, 204, 204, 201, 204, 207, 203, 200 ],
	[ 207, 207, 204, 207, 204, 204, 204, 204, 204, 204, 204, 204, 203, 200, 204, 201 ],
	[ 207, 207, 204, 207, 204, 204, 204, 204, 204, 204, 204, 204, 204, 204, 200, 201 ],
	[ 207, 207, 204, 208, 204, 204, 204, 204, 204, 204, 204, 204, 204, 204, 202, 201 ],
	[ 207, 208, 204, 204, 208, 205, 204, 204, 204, 204, 204, 204, 204, 201, 204, 201 ],
	[ 207, 204, 208, 204, 204, 204, 208, 204, 204, 204, 204, 204, 204, 201, 204, 201 ],
	[ 207, 204, 204, 208, 204, 204, 204, 208, 204, 204, 204, 204, 204, 202, 204, 202 ],
	[ 208, 204, 204, 204, 208, 204, 204, 204, 208, 205, 205, 205, 202, 204, 201, 201 ],
	[ 1, 208, 205, 204, 204, 208, 204, 204, 204, 204, 204, 204, 204, 204, 202, 201 ],
	[ 10, 10, 15, 208, 205, 205, 208, 205, 205, 205, 205, 205, 205, 202, 205, 202 ]
],
"objects": [
	{
		"class": "io.github.pokemeetup.system.gameplay.overworld.World$WorldObjectData",
		"x": 1984,
		"y": -1536,
		"type": "TREE_0"
	},
	{
		"class": "io.github.pokemeetup.system.gameplay.overworld.World$WorldObjectData",
		"x": 1568,
		"y": -1056,
		"type": "TREE_0"
	},
	{
		"class": "io.github.pokemeetup.system.gameplay.overworld.World$WorldObjectData",
		"x": 1536,
		"y": -1536,
		"type": "TREE_1"
	},
	{
		"class": "io.github.pokemeetup.system.gameplay.overworld.World$WorldObjectData",
		"x": 1664,
		"y": -1056,
		"type": "TREE_1"
	},
	{
		"class": "io.github.pokemeetup.system.gameplay.overworld.World$WorldObjectData",
		"x": 1536,
		"y": -1408,
		"type": "SUNFLOWER"
	},
	{
		"class": "io.github.pokemeetup.system.gameplay.overworld.World$WorldObjectData",
		"x": 1536,
		"y": -1472,
		"type": "POKEBALL"
	}
],
"blocks": [],
"lastModified": 0,
"isMultiplayer": false
}