{
"x": 2,
"y": -1,
"biomeType": "HAUNTED",
"tileData": [
	[ 206, 203, 203, 200, 5, 5, 5, 5, 5, 7, 5, 5, 5, 9, 10, 5 ],
	[ 207, 204, 204, 204, 200, 5, 1, 7, 7, 5, 9, 5, 5, 5, 5, 5 ],
	[ 207, 204, 204, 204, 204, 200, 5, 9, 5, 7, 5, 5, 5, 5, 5, 1 ],
	[ 207, 204, 204, 204, 204, 204, 200, 5, 7, 7, 9, 5, 8, 7, 5, 7 ],
	[ 207, 204, 204, 204, 204, 204, 204, 200, 7, 7, 5, 7, 7, 5, 5, 5 ],
	[ 207, 204, 204, 204, 204, 204, 204, 204, 203, 200, 5, 235, 9, 5, 5, 7 ],
	[ 207, 204, 204, 206, 200, 204, 204, 204, 204, 204, 203, 200, 5, 5, 5, 5 ],
	[ 207, 204, 206, 204, 204, 200, 204, 204, 204, 204, 204, 204, 203, 200, 7, 8 ],
	[ 207, 204, 208, 204, 204, 202, 204, 204, 204, 204, 204, 204, 204, 204, 200, 5 ],
	[ 207, 204, 204, 208, 202, 204, 204, 204, 204, 204, 204, 204, 204, 204, 201, 8 ],
	[ 207, 204, 204, 204, 204, 204, 204, 204, 204, 204, 204, 204, 204, 204, 204, 200 ],
	[ 208, 204, 204, 204, 204, 204, 204, 204, 204, 204, 204, 204, 204, 204, 204, 201 ],
	[ 1, 208, 205, 204, 204, 205, 204, 204, 204, 204, 204, 204, 204, 204, 204, 202 ],
	[ 10, 24, 7, 208, 202, 5, 208, 204, 204, 204, 204, 204, 204, 204, 202, 9 ],
	[ 1, 10, 10, 1, 7, 5, 7, 208, 204, 204, 204, 204, 205, 202, 5, 7 ],
	[ 1, 10, 24, 1, 5, 7, 5, 5, 208, 205, 205, 202, 7, 7, 5, 9 ]
],
"objects": [
	{
		"class": "io.github.pokemeetup.system.gameplay.overworld.World$WorldObjectData",
		"x": 1472,
		"y": -512,
		"type": "TREE_0"
	},
	{
		"class": "io.github.pokemeetup.system.gameplay.overworld.World$WorldObjectData",
		"x": 1088,
		"y": -32,
		"type": "SUNFLOWER"
	},
	{
		"class": "io.github.pokemeetup.system.gameplay.overworld.World$WorldObjectData",
		"x": 1504,
		"y": -416,
		"type": "POKEBALL"
	}
],
"blocks": [],
"lastModified": 0,
"isMultiplayer": false
}