{
"x": -3,
"y": 1,
"biomeType": "PLAINS",
"tileData": [
	[ 10, 1, 1, 10, 1, 1, 1, 1, 1, 1, 10, 1, 1, 1, 1, 10 ],
	[ 1, 1, 1, 1, 1, 1, 10, 10, 10, 10, 1, 10, 1, 10, 1, 10 ],
	[ 1, 10, 1, 1, 1, 1, 1, 1, 1, 10, 1, 1, 1, 10, 10, 1 ],
	[ 1, 1, 1, 1, 1, 1, 1, 1, 1, 1, 10, 1, 1, 10, 1, 1 ],
	[ 1, 1, 1, 1, 1, 1, 1, 10, 1, 10, 1, 10, 10, 1, 10, 1 ],
	[ 1, 10, 1, 1, 1, 1, 1, 1, 1, 1, 1, 1, 1, 1, 10, 1 ],
	[ 1, 10, 1, 1, 10, 1, 1, 1, 1, 10, 1, 1, 1, 1, 1, 1 ],
	[ 10, 1, 10, 10, 1, 1, 1, 1, 1, 1, 1, 1, 1, 1, 1, 1 ],
	[ 1, 1, 1, 1, 1, 1, 1, 1, 1, 1, 1, 10, 10, 1, 1, 1 ],
	[ 1, 1, 1, 10, 1, 1, 1, 1, 1, 1, 1, 1, 1, 1, 10, 1 ],
	[ 10, 1, 1, 1, 1, 10, 1, 1, 1, 10, 1, 1, 1, 1, 1, 10 ],
	[ 1, 1, 1, 1, 1, 1, 1, 1, 1, 1, 1, 1, 1, 1, 1, 10 ],
	[ 1, 10, 1, 1, 10, 1, 1, 1, 1, 1, 1, 10, 1, 10, 10, 1 ],
	[ 10, 1, 1, 1, 1, 10, 1, 1, 1, 1, 1, 1, 1, 1, 1, 10 ],
	[ 1, 1, 1, 1, 10, 1, 1, 1, 1, 10, 1, 10, 1, 1, 1, 1 ],
	[ 1, 10, 1, 1, 1, 10, 1, 10, 10, 1, 1, 1, 1, 1, 1, 1 ]
],
"objects": [
	{
		"x": -1120,
		"y": 800,
		"type": "POKEBALL"
	},
	{
		"x": -1472,
		"y": 736,
		"type": "POKEBALL"
	},
	{
		"x": -1056,
		"y": 928,
		"type": "POKEBALL"
	},
	{
		"x": -1312,
		"y": 704,
		"type": "POKEBALL"
	},
	{
		"x": -1248,
		"y": 704,
		"type": "POKEBALL"
	},
	{
		"x": -1536,
		"y": 544,
		"type": "POKEBALL"
	}
],
"lastModified": 1730134456072,
"isMultiplayer": true
}