{
"x": -13,
"y": -1,
"biomeType": "HAUNTED",
"tileData": [
	[ 5, 5, 9, 9, 9, 5, 5, 9, 5, 5, 9, 9, 5, 5, 5, 7 ],
	[ 9, 5, 5, 5, 9, 5, 5, 5, 7, 5, 5, 5, 5, 5, 5, 7 ],
	[ 5, 5, 5, 5, 5, 5, 5, 5, 5, 5, 5, 5, 9, 5, 5, 7 ],
	[ 5, 5, 5, 5, 5, 5, 5, 8, 8, 7, 5, 7, 7, 9, 5, 5 ],
	[ 5, 5, 9, 5, 5, 5, 5, 9, 7, 5, 8, 5, 5, 5, 7, 5 ],
	[ 7, 9, 5, 7, 5, 5, 8, 5, 9, 9, 5, 5, 8, 5, 5, 5 ],
	[ 5, 5, 9, 7, 8, 9, 5, 5, 5, 8, 5, 9, 5, 5, 5, 5 ],
	[ 5, 5, 7, 5, 7, 5, 9, 5, 5, 5, 7, 9, 5, 5, 5, 7 ],
	[ 5, 9, 5, 5, 5, 5, 9, 5, 5, 5, 5, 7, 5, 5, 5, 5 ],
	[ 5, 7, 9, 5, 5, 9, 7, 5, 5, 5, 9, 9, 7, 7, 5, 7 ],
	[ 7, 5, 5, 5, 7, 5, 5, 9, 5, 9, 5, 5, 9, 9, 5, 5 ],
	[ 5, 5, 7, 7, 5, 5, 5, 5, 5, 9, 5, 7, 5, 9, 9, 9 ],
	[ 5, 5, 5, 5, 5, 7, 5, 5, 5, 5, 5, 9, 5, 7, 5, 5 ],
	[ 5, 9, 5, 5, 5, 7, 7, 5, 7, 8, 5, 9, 9, 5, 9, 7 ],
	[ 8, 7, 9, 5, 5, 7, 5, 5, 5, 5, 5, 8, 9, 9, 5, 9 ],
	[ 9, 5, 5, 8, 7, 5, 5, 9, 5, 7, 5, 5, 5, 5, 9, 5 ]
],
"objects": [
	{
		"x": -6528,
		"y": -256,
		"type": "HAUNTED_TREE"
	},
	{
		"x": -6272,
		"y": -192,
		"type": "HAUNTED_TREE"
	}
],
"lastModified": 1730134596108,
"isMultiplayer": true
}