{
"x": 2,
"biomeType": "HAUNTED",
"tileData": [
	[ 5, 9, 9, 9, 5, 5, 5, 7, 5, 5, 9, 7, 9, 9, 5, 5 ],
	[ 7, 5, 5, 5, 5, 5, 5, 9, 5, 5, 9, 5, 5, 9, 5, 5 ],
	[ 5, 8, 5, 5, 7, 7, 5, 5, 5, 7, 5, 7, 9, 5, 5, 5 ],
	[ 5, 5, 9, 9, 5, 5, 9, 5, 5, 5, 5, 5, 5, 7, 5, 7 ],
	[ 7, 5, 5, 9, 7, 9, 5, 5, 5, 9, 5, 5, 8, 7, 7, 9 ],
	[ 5, 7, 5, 5, 5, 7, 5, 5, 5, 5, 5, 5, 9, 9, 9, 5 ],
	[ 5, 5, 9, 5, 5, 5, 5, 5, 5, 5, 5, 5, 5, 5, 5, 5 ],
	[ 5, 5, 5, 5, 5, 5, 7, 5, 9, 5, 9, 5, 5, 5, 5, 5 ],
	[ 7, 8, 5, 5, 5, 8, 5, 9, 5, 5, 5, 9, 5, 5, 5, 5 ],
	[ 9, 5, 5, 9, 7, 8, 5, 5, 5, 5, 9, 5, 5, 7, 9, 5 ],
	[ 5, 5, 5, 5, 7, 9, 5, 9, 5, 7, 5, 9, 5, 9, 5, 5 ],
	[ 5, 5, 9, 5, 9, 5, 7, 5, 9, 5, 5, 5, 5, 5, 5, 5 ],
	[ 5, 7, 9, 8, 5, 5, 8, 5, 5, 5, 7, 7, 9, 5, 9, 7 ],
	[ 5, 7, 5, 5, 9, 5, 5, 9, 5, 9, 9, 5, 9, 9, 9, 9 ],
	[ 5, 5, 5, 5, 7, 7, 5, 5, 5, 5, 5, 9, 9, 9, 9, 7 ],
	[ 5, 5, 5, 5, 7, 5, 5, 5, 5, 5, 5, 5, 5, 5, 5, 9 ]
],
"objects": [
	{
		"x": 1088,
		"y": 128,
		"type": "HAUNTED_TREE"
	}
],
"lastModified": 1730127108214,
"isMultiplayer": true
}