{
"x": 2,
"y": -6,
"biomeType": "HAUNTED",
"tileData": [
	[ 5, 5, 5, 5, 8, 5, 9, 5, 5, 9, 5, 5, 5, 5, 5, 5 ],
	[ 9, 5, 5, 5, 5, 5, 5, 5, 5, 7, 5, 5, 7, 7, 9, 9 ],
	[ 9, 5, 5, 5, 9, 5, 5, 7, 5, 5, 8, 9, 5, 5, 5, 5 ],
	[ 5, 9, 7, 9, 7, 9, 7, 5, 9, 5, 5, 5, 5, 9, 5, 5 ],
	[ 5, 5, 7, 5, 5, 7, 5, 5, 5, 5, 5, 7, 5, 8, 5, 5 ],
	[ 5, 9, 9, 8, 7, 9, 9, 5, 7, 5, 5, 5, 8, 5, 5, 5 ],
	[ 7, 5, 5, 5, 5, 9, 5, 5, 7, 5, 7, 5, 7, 5, 5, 5 ],
	[ 9, 5, 5, 9, 7, 5, 8, 9, 5, 5, 5, 5, 9, 5, 9, 5 ],
	[ 5, 7, 5, 7, 5, 7, 5, 5, 7, 9, 5, 8, 5, 5, 5, 9 ],
	[ 5, 5, 9, 5, 9, 5, 7, 5, 5, 8, 7, 9, 5, 8, 7, 5 ],
	[ 9, 5, 9, 5, 5, 9, 5, 9, 9, 5, 9, 5, 5, 5, 9, 5 ],
	[ 9, 5, 9, 5, 5, 5, 5, 7, 5, 5, 5, 5, 5, 5, 5, 5 ],
	[ 5, 5, 5, 5, 9, 5, 8, 5, 5, 5, 9, 9, 5, 5, 7, 9 ],
	[ 7, 5, 9, 9, 5, 5, 9, 5, 9, 5, 5, 7, 5, 9, 9, 5 ],
	[ 5, 5, 5, 5, 5, 5, 9, 7, 9, 5, 9, 9, 5, 5, 5, 5 ],
	[ 5, 5, 5, 5, 5, 5, 5, 5, 7, 7, 5, 9, 9, 9, 7, 5 ]
],
"objects": [
	{
		"x": 1184,
		"y": -2720,
		"type": "HAUNTED_TREE"
	},
	{
		"x": 1376,
		"y": -2784,
		"type": "HAUNTED_TREE"
	}
],
"lastModified": 1730134427741,
"isMultiplayer": true
}