{
"x": -6,
"y": 1,
"biomeType": "PLAINS",
"tileData": [
	[ 1, 1, 1, 1, 1, 1, 10, 10, 1, 1, 1, 1, 10, 10, 1, 10 ],
	[ 1, 1, 1, 10, 1, 1, 1, 1, 1, 10, 1, 1, 10, 10, 10, 1 ],
	[ 1, 1, 1, 1, 1, 1, 1, 10, 1, 10, 1, 10, 10, 1, 1, 1 ],
	[ 1, 1, 1, 10, 10, 1, 10, 1, 1, 1, 1, 1, 1, 1, 1, 10 ],
	[ 1, 1, 1, 1, 1, 1, 1, 1, 10, 1, 10, 1, 1, 1, 1, 1 ],
	[ 10, 1, 1, 1, 1, 1, 10, 10, 1, 10, 10, 1, 10, 1, 1, 1 ],
	[ 1, 10, 1, 1, 1, 1, 1, 1, 1, 1, 1, 10, 10, 1, 1, 1 ],
	[ 10, 1, 1, 1, 1, 1, 1, 1, 10, 1, 1, 10, 1, 1, 1, 1 ],
	[ 1, 1, 10, 10, 10, 10, 1, 1, 1, 1, 1, 1, 10, 10, 1, 1 ],
	[ 1, 1, 1, 1, 10, 1, 1, 1, 1, 1, 10, 1, 1, 10, 1, 1 ],
	[ 10, 10, 1, 1, 10, 1, 10, 1, 1, 1, 1, 1, 10, 1, 1, 1 ],
	[ 1, 1, 1, 1, 10, 1, 10, 10, 10, 1, 1, 10, 1, 1, 1, 10 ],
	[ 10, 1, 1, 1, 1, 1, 1, 1, 1, 1, 1, 1, 1, 10, 1, 1 ],
	[ 1, 10, 1, 1, 1, 10, 1, 1, 1, 1, 1, 1, 1, 1, 1, 1 ],
	[ 1, 1, 1, 1, 1, 10, 10, 1, 1, 1, 1, 1, 10, 1, 1, 1 ],
	[ 1, 1, 1, 10, 1, 1, 1, 1, 1, 1, 1, 1, 1, 10, 10, 10 ]
],
"objects": [
	{
		"x": -2848,
		"y": 736,
		"type": "TREE"
	},
	{
		"x": -2880,
		"y": 672,
		"type": "POKEBALL"
	},
	{
		"x": -2656,
		"y": 896,
		"type": "POKEBALL"
	},
	{
		"x": -3040,
		"y": 736,
		"type": "POKEBALL"
	}
],
"lastModified": 1730134480760,
"isMultiplayer": true
}