{
"x": -6,
"y": -1,
"biomeType": "HAUNTED",
"tileData": [
	[ 5, 7, 7, 9, 9, 9, 9, 5, 9, 5, 9, 9, 7, 5, 5, 5 ],
	[ 5, 5, 5, 5, 5, 8, 5, 9, 5, 7, 5, 5, 5, 5, 5, 9 ],
	[ 5, 5, 5, 5, 7, 5, 9, 5, 5, 5, 5, 5, 7, 7, 5, 7 ],
	[ 5, 5, 5, 5, 9, 5, 5, 9, 5, 5, 5, 5, 5, 5, 5, 5 ],
	[ 5, 5, 5, 7, 5, 5, 7, 5, 7, 5, 8, 5, 5, 5, 5, 5 ],
	[ 9, 5, 7, 5, 5, 5, 5, 5, 5, 5, 9, 7, 5, 8, 5, 7 ],
	[ 5, 8, 5, 5, 5, 9, 7, 9, 5, 5, 5, 5, 5, 9, 5, 9 ],
	[ 5, 7, 5, 5, 9, 5, 5, 9, 5, 5, 5, 5, 5, 9, 7, 9 ],
	[ 9, 7, 5, 7, 5, 9, 5, 7, 5, 5, 5, 9, 9, 5, 5, 5 ],
	[ 5, 5, 7, 9, 9, 5, 5, 5, 5, 5, 5, 7, 7, 5, 5, 5 ],
	[ 5, 5, 9, 9, 5, 9, 9, 9, 9, 5, 7, 5, 5, 5, 5, 5 ],
	[ 5, 9, 5, 5, 5, 5, 5, 9, 9, 7, 5, 5, 5, 5, 9, 7 ],
	[ 5, 5, 5, 5, 5, 7, 5, 9, 9, 5, 9, 5, 9, 5, 7, 5 ],
	[ 5, 5, 5, 5, 7, 5, 5, 5, 9, 5, 9, 5, 9, 5, 5, 5 ],
	[ 5, 7, 7, 5, 5, 5, 8, 5, 5, 7, 8, 9, 9, 8, 5, 5 ],
	[ 5, 5, 5, 7, 5, 5, 5, 5, 5, 5, 5, 9, 5, 5, 5, 9 ]
],
"objects": [
	{
		"x": -2976,
		"y": -448,
		"type": "HAUNTED_TREE"
	}
],
"lastModified": 1730134480757,
"isMultiplayer": true
}