{
"x": -4,
"y": 1,
"biomeType": "PLAINS",
"tileData": [
	[ 1, 1, 1, 1, 1, 10, 1, 1, 1, 1, 10, 10, 1, 10, 10, 1 ],
	[ 1, 1, 1, 1, 1, 1, 1, 1, 1, 10, 1, 10, 1, 1, 1, 1 ],
	[ 1, 1, 1, 10, 10, 1, 1, 1, 1, 1, 1, 1, 10, 1, 1, 1 ],
	[ 1, 1, 1, 1, 10, 1, 10, 1, 1, 1, 1, 1, 10, 1, 1, 1 ],
	[ 1, 10, 1, 1, 1, 10, 1, 1, 1, 1, 10, 10, 10, 1, 1, 1 ],
	[ 1, 1, 1, 1, 1, 10, 1, 1, 1, 1, 10, 1, 1, 1, 1, 1 ],
	[ 1, 1, 1, 1, 1, 1, 1, 1, 1, 1, 1, 1, 10, 1, 1, 1 ],
	[ 1, 10, 1, 1, 1, 10, 1, 1, 1, 10, 10, 10, 1, 1, 1, 1 ],
	[ 1, 1, 1, 1, 1, 1, 1, 1, 10, 1, 1, 10, 1, 10, 10, 1 ],
	[ 1, 1, 1, 1, 1, 1, 1, 1, 10, 1, 1, 1, 10, 1, 1, 1 ],
	[ 1, 1, 1, 10, 1, 10, 1, 10, 10, 1, 1, 1, 10, 1, 1, 1 ],
	[ 10, 1, 1, 1, 10, 1, 1, 1, 1, 1, 1, 1, 1, 10, 1, 1 ],
	[ 1, 1, 10, 10, 1, 1, 1, 1, 1, 1, 10, 1, 10, 1, 1, 1 ],
	[ 1, 1, 1, 1, 10, 1, 1, 1, 1, 1, 1, 1, 1, 10, 1, 1 ],
	[ 1, 1, 1, 1, 1, 1, 1, 1, 1, 10, 1, 1, 1, 1, 10, 1 ],
	[ 1, 10, 1, 1, 1, 1, 1, 1, 10, 10, 1, 1, 1, 1, 1, 1 ]
],
"objects": [
	{
		"x": -1760,
		"y": 800,
		"type": "TREE"
	}
],
"lastModified": 1730134459675,
"isMultiplayer": true
}