{
"x": -11,
"y": -3,
"biomeType": "HAUNTED",
"tileData": [
	[ 5, 5, 5, 9, 5, 9, 5, 9, 5, 5, 7, 5, 5, 7, 5, 5 ],
	[ 5, 9, 5, 9, 7, 5, 9, 7, 5, 5, 5, 5, 5, 5, 7, 5 ],
	[ 7, 9, 5, 5, 8, 9, 5, 9, 5, 9, 5, 5, 5, 5, 5, 9 ],
	[ 9, 9, 5, 9, 5, 9, 9, 8, 5, 5, 8, 5, 8, 5, 5, 5 ],
	[ 5, 5, 5, 5, 5, 7, 5, 5, 5, 5, 5, 5, 5, 8, 5, 5 ],
	[ 7, 5, 5, 5, 8, 5, 7, 5, 5, 5, 5, 5, 9, 9, 5, 5 ],
	[ 7, 5, 9, 5, 5, 5, 9, 9, 5, 5, 5, 5, 5, 5, 5, 5 ],
	[ 9, 7, 5, 5, 5, 7, 5, 5, 7, 7, 5, 5, 5, 9, 5, 5 ],
	[ 5, 5, 8, 5, 5, 7, 9, 9, 9, 5, 8, 5, 5, 9, 5, 9 ],
	[ 5, 5, 9, 5, 5, 5, 5, 9, 5, 5, 9, 5, 9, 5, 5, 5 ],
	[ 5, 8, 5, 5, 9, 9, 5, 5, 9, 5, 5, 5, 5, 5, 5, 5 ],
	[ 5, 5, 5, 5, 5, 5, 5, 5, 5, 5, 5, 9, 5, 5, 9, 5 ],
	[ 7, 9, 5, 5, 5, 5, 5, 5, 5, 5, 9, 7, 5, 9, 5, 9 ],
	[ 7, 9, 5, 5, 7, 5, 7, 5, 9, 5, 7, 5, 7, 5, 5, 7 ],
	[ 7, 9, 5, 5, 5, 5, 8, 5, 9, 5, 9, 5, 9, 5, 5, 5 ],
	[ 8, 5, 5, 7, 5, 5, 5, 9, 7, 7, 7, 5, 5, 5, 5, 5 ]
],
"objects": [
	{
		"x": -5408,
		"y": -1376,
		"type": "HAUNTED_TREE"
	}
],
"lastModified": 1730134601018,
"isMultiplayer": true
}