{
"x": -6,
"biomeType": "HAUNTED",
"tileData": [
	[ 9, 5, 5, 9, 8, 5, 5, 5, 5, 5, 5, 9, 5, 5, 5, 9 ],
	[ 9, 5, 9, 9, 9, 5, 5, 5, 9, 5, 5, 5, 7, 5, 5, 5 ],
	[ 5, 5, 5, 5, 7, 5, 5, 5, 5, 7, 7, 5, 5, 9, 5, 7 ],
	[ 5, 5, 5, 5, 5, 5, 7, 5, 5, 9, 9, 5, 5, 5, 5, 5 ],
	[ 7, 5, 5, 7, 5, 5, 5, 9, 5, 9, 9, 7, 5, 5, 5, 5 ],
	[ 7, 5, 5, 5, 9, 5, 5, 5, 9, 5, 9, 5, 5, 9, 9, 5 ],
	[ 5, 5, 5, 5, 5, 5, 9, 9, 5, 9, 9, 7, 5, 5, 5, 5 ],
	[ 7, 5, 5, 7, 5, 5, 8, 5, 5, 9, 5, 5, 5, 5, 5, 5 ],
	[ 5, 8, 7, 5, 5, 9, 9, 9, 9, 8, 5, 5, 5, 5, 5, 8 ],
	[ 5, 9, 5, 5, 7, 5, 9, 5, 5, 5, 5, 9, 9, 5, 9, 5 ],
	[ 5, 7, 5, 9, 9, 5, 5, 5, 5, 5, 5, 5, 9, 5, 5, 5 ],
	[ 5, 9, 5, 5, 5, 5, 8, 9, 7, 9, 8, 5, 5, 9, 5, 9 ],
	[ 5, 5, 5, 5, 5, 5, 5, 7, 5, 9, 9, 5, 7, 7, 7, 7 ],
	[ 9, 7, 9, 5, 9, 5, 5, 9, 5, 5, 5, 9, 5, 5, 5, 5 ],
	[ 7, 9, 5, 5, 9, 5, 5, 5, 5, 9, 9, 5, 9, 7, 5, 5 ],
	[ 5, 5, 5, 5, 7, 5, 9, 7, 5, 5, 5, 7, 8, 5, 5, 5 ]
],
"objects": [
	{
		"x": -2720,
		"y": 256,
		"type": "HAUNTED_TREE"
	},
	{
		"x": -2688,
		"y": 128,
		"type": "HAUNTED_TREE"
	}
],
"lastModified": 1730134480758,
"isMultiplayer": true
}