{
"x": -5,
"y": 1,
"biomeType": "PLAINS",
"tileData": [
	[ 1, 10, 1, 1, 1, 1, 1, 1, 1, 1, 1, 1, 1, 1, 1, 10 ],
	[ 1, 10, 10, 10, 1, 1, 10, 1, 10, 1, 1, 10, 1, 10, 1, 1 ],
	[ 10, 1, 10, 10, 10, 1, 1, 10, 10, 1, 1, 1, 1, 1, 1, 1 ],
	[ 1, 10, 1, 10, 1, 1, 1, 1, 1, 1, 1, 1, 10, 10, 1, 1 ],
	[ 1, 1, 1, 1, 1, 1, 1, 1, 10, 1, 1, 1, 1, 1, 1, 1 ],
	[ 10, 1, 1, 1, 10, 1, 1, 1, 1, 10, 1, 1, 1, 1, 1, 1 ],
	[ 1, 1, 1, 1, 1, 10, 1, 1, 1, 1, 1, 1, 1, 1, 10, 1 ],
	[ 10, 1, 10, 1, 1, 1, 1, 1, 1, 10, 1, 1, 1, 1, 1, 1 ],
	[ 10, 1, 1, 1, 1, 1, 1, 1, 1, 1, 1, 1, 1, 1, 10, 1 ],
	[ 1, 10, 1, 1, 10, 1, 1, 1, 1, 1, 1, 1, 1, 1, 1, 1 ],
	[ 1, 1, 1, 1, 1, 1, 1, 1, 1, 10, 1, 1, 1, 1, 1, 10 ],
	[ 1, 1, 1, 1, 1, 1, 1, 1, 1, 1, 10, 10, 10, 1, 1, 1 ],
	[ 1, 1, 1, 1, 1, 10, 1, 1, 1, 1, 1, 1, 1, 1, 1, 1 ],
	[ 1, 10, 1, 1, 1, 1, 1, 1, 1, 1, 1, 1, 1, 1, 1, 1 ],
	[ 10, 1, 1, 1, 1, 1, 1, 1, 1, 1, 1, 1, 10, 1, 1, 1 ],
	[ 1, 1, 1, 1, 1, 1, 1, 1, 1, 10, 1, 1, 1, 1, 1, 1 ]
],
"objects": [
	{
		"x": -2080,
		"y": 928,
		"type": "POKEBALL"
	},
	{
		"x": -2400,
		"y": 960,
		"type": "POKEBALL"
	},
	{
		"x": -2208,
		"y": 800,
		"type": "POKEBALL"
	},
	{
		"x": -2304,
		"y": 928,
		"type": "POKEBALL"
	},
	{
		"x": -2304,
		"y": 832,
		"type": "POKEBALL"
	},
	{
		"x": -2080,
		"y": 736,
		"type": "POKEBALL"
	},
	{
		"x": -2272,
		"y": 576,
		"type": "POKEBALL"
	}
],
"lastModified": 1730134463513,
"isMultiplayer": true
}