{
"x": -16,
"y": 1,
"biomeType": "HAUNTED",
"tileData": [
	[ 5, 5, 9, 5, 9, 5, 5, 5, 9, 9, 9, 9, 8, 5, 7, 8 ],
	[ 5, 5, 5, 5, 5, 9, 5, 5, 5, 5, 7, 5, 8, 5, 7, 5 ],
	[ 5, 5, 5, 5, 5, 5, 5, 5, 5, 7, 5, 9, 5, 5, 9, 5 ],
	[ 5, 5, 5, 5, 5, 5, 9, 9, 5, 5, 5, 5, 5, 5, 9, 5 ],
	[ 5, 5, 7, 8, 7, 5, 5, 5, 5, 5, 5, 5, 5, 5, 9, 8 ],
	[ 9, 9, 5, 5, 5, 5, 5, 5, 5, 7, 7, 7, 5, 5, 5, 5 ],
	[ 7, 5, 5, 5, 7, 5, 7, 5, 5, 7, 5, 9, 5, 7, 5, 5 ],
	[ 5, 5, 5, 5, 5, 5, 5, 5, 7, 5, 9, 5, 5, 5, 5, 5 ],
	[ 5, 5, 7, 5, 5, 5, 8, 5, 5, 7, 5, 5, 5, 5, 5, 5 ],
	[ 9, 5, 5, 5, 5, 5, 8, 5, 5, 5, 9, 5, 5, 5, 9, 5 ],
	[ 9, 9, 5, 5, 5, 8, 5, 7, 7, 7, 5, 7, 5, 5, 7, 5 ],
	[ 7, 5, 5, 7, 5, 7, 5, 5, 5, 5, 5, 7, 5, 7, 5, 7 ],
	[ 5, 7, 5, 5, 5, 5, 9, 9, 5, 7, 9, 7, 5, 5, 9, 5 ],
	[ 7, 5, 9, 5, 9, 5, 9, 5, 5, 5, 5, 5, 5, 5, 8, 7 ],
	[ 9, 9, 7, 9, 5, 5, 5, 5, 7, 5, 5, 8, 7, 7, 7, 5 ],
	[ 9, 5, 7, 5, 5, 5, 5, 8, 5, 8, 9, 5, 5, 7, 9, 5 ]
],
"objects": [
	{
		"x": -8032,
		"y": 832,
		"type": "HAUNTED_TREE"
	},
	{
		"x": -7968,
		"y": 640,
		"type": "HAUNTED_TREE"
	}
],
"lastModified": 1730134512195,
"isMultiplayer": true
}