{
"x": 2,
"y": 3,
"biomeType": "PLAINS",
"tileData": [
	[ 1, 1, 10, 1, 10, 1, 1, 10, 1, 10, 10, 1, 1, 1, 1, 1 ],
	[ 1, 1, 10, 1, 1, 1, 1, 10, 1, 1, 1, 1, 10, 1, 10, 1 ],
	[ 1, 10, 1, 1, 1, 1, 1, 1, 1, 10, 1, 1, 1, 1, 1, 1 ],
	[ 1, 1, 1, 10, 1, 1, 1, 1, 1, 1, 1, 10, 1, 1, 1, 1 ],
	[ 10, 1, 1, 1, 1, 1, 1, 1, 1, 1, 1, 1, 1, 1, 1, 10 ],
	[ 1, 1, 1, 1, 1, 1, 10, 1, 1, 1, 1, 1, 1, 1, 1, 10 ],
	[ 1, 1, 1, 1, 1, 10, 1, 1, 10, 1, 1, 1, 1, 10, 1, 1 ],
	[ 1, 1, 1, 1, 1, 1, 1, 1, 1, 1, 1, 1, 1, 1, 1, 1 ],
	[ 1, 1, 1, 10, 1, 1, 1, 1, 1, 10, 1, 10, 1, 1, 1, 1 ],
	[ 1, 1, 1, 1, 1, 1, 1, 1, 10, 10, 1, 1, 1, 10, 1, 1 ],
	[ 1, 1, 1, 1, 1, 1, 1, 10, 1, 10, 1, 1, 1, 1, 1, 10 ],
	[ 1, 1, 1, 1, 10, 1, 1, 1, 1, 1, 1, 10, 1, 1, 1, 1 ],
	[ 1, 1, 10, 1, 1, 1, 1, 1, 1, 10, 1, 10, 1, 1, 1, 1 ],
	[ 1, 10, 1, 1, 1, 1, 1, 1, 1, 10, 1, 1, 1, 1, 10, 1 ],
	[ 1, 1, 1, 10, 1, 1, 10, 10, 1, 1, 10, 1, 10, 1, 1, 10 ],
	[ 1, 10, 1, 1, 1, 1, 1, 1, 10, 1, 10, 1, 1, 10, 1, 1 ]
],
"objects": [
	{
		"x": 1376,
		"y": 1760,
		"type": "TREE"
	}
],
"lastModified": 1730135519245,
"isMultiplayer": true
}