{
"x": -9,
"y": 1,
"biomeType": "PLAINS",
"tileData": [
	[ 10, 1, 10, 1, 1, 1, 1, 10, 1, 10, 1, 1, 10, 10, 1, 1 ],
	[ 1, 1, 1, 1, 1, 10, 1, 1, 1, 1, 10, 1, 1, 1, 1, 10 ],
	[ 1, 10, 1, 10, 1, 1, 1, 1, 1, 1, 1, 1, 1, 1, 1, 1 ],
	[ 1, 1, 1, 10, 10, 1, 10, 1, 1, 1, 1, 1, 10, 1, 1, 1 ],
	[ 1, 1, 1, 1, 10, 1, 1, 1, 1, 1, 1, 1, 10, 1, 1, 1 ],
	[ 10, 1, 1, 1, 1, 1, 1, 1, 1, 1, 1, 1, 1, 1, 1, 1 ],
	[ 1, 1, 10, 1, 1, 1, 10, 10, 1, 1, 1, 1, 1, 1, 1, 10 ],
	[ 1, 1, 10, 1, 1, 1, 1, 1, 10, 1, 10, 10, 10, 1, 10, 1 ],
	[ 10, 1, 1, 10, 1, 10, 1, 1, 1, 1, 10, 1, 1, 1, 1, 1 ],
	[ 10, 1, 1, 1, 10, 1, 1, 10, 1, 1, 1, 1, 1, 1, 1, 1 ],
	[ 1, 1, 1, 1, 1, 1, 1, 1, 1, 1, 1, 1, 10, 1, 10, 1 ],
	[ 1, 10, 1, 1, 1, 1, 1, 1, 1, 1, 1, 10, 10, 1, 10, 1 ],
	[ 1, 10, 1, 1, 1, 10, 1, 1, 10, 1, 1, 1, 1, 1, 1, 1 ],
	[ 1, 1, 1, 1, 1, 10, 1, 10, 1, 1, 1, 1, 1, 1, 1, 10 ],
	[ 1, 1, 10, 1, 1, 10, 1, 1, 1, 1, 1, 1, 1, 1, 10, 1 ],
	[ 1, 1, 10, 10, 1, 1, 1, 10, 1, 1, 1, 1, 1, 10, 10, 10 ]
],
"objects": [
	{
		"x": -4384,
		"y": 608,
		"type": "TREE"
	},
	{
		"x": -4320,
		"y": 864,
		"type": "POKEBALL"
	},
	{
		"x": -4416,
		"y": 672,
		"type": "POKEBALL"
	},
	{
		"x": -4128,
		"y": 640,
		"type": "POKEBALL"
	},
	{
		"x": -4512,
		"y": 576,
		"type": "POKEBALL"
	},
	{
		"x": -4320,
		"y": 800,
		"type": "POKEBALL"
	},
	{
		"x": -4480,
		"y": 768,
		"type": "POKEBALL"
	}
],
"lastModified": 1730134602330,
"isMultiplayer": true
}