{
"x": -4,
"y": -7,
"biomeType": "HAUNTED",
"tileData": [
	[ 7, 9, 7, 9, 5, 5, 5, 5, 5, 9, 5, 8, 9, 5, 5, 7 ],
	[ 5, 5, 5, 5, 9, 5, 5, 5, 5, 9, 9, 5, 7, 5, 7, 5 ],
	[ 5, 5, 5, 5, 5, 5, 5, 9, 9, 5, 5, 5, 5, 5, 5, 5 ],
	[ 9, 7, 7, 5, 5, 5, 5, 5, 5, 5, 5, 5, 5, 5, 5, 5 ],
	[ 5, 5, 5, 9, 5, 5, 5, 7, 5, 5, 7, 5, 5, 5, 7, 5 ],
	[ 5, 8, 7, 5, 5, 7, 5, 5, 5, 5, 9, 9, 5, 8, 9, 7 ],
	[ 5, 9, 5, 7, 5, 5, 7, 9, 9, 5, 8, 5, 7, 7, 5, 5 ],
	[ 5, 5, 8, 7, 9, 5, 5, 5, 7, 5, 5, 7, 7, 7, 5, 5 ],
	[ 5, 9, 5, 5, 5, 5, 9, 5, 5, 5, 5, 5, 5, 7, 5, 7 ],
	[ 5, 5, 5, 5, 9, 8, 5, 5, 7, 5, 5, 5, 9, 5, 9, 9 ],
	[ 9, 5, 5, 5, 5, 5, 5, 7, 7, 5, 5, 5, 5, 9, 5, 7 ],
	[ 9, 5, 5, 7, 5, 5, 9, 7, 5, 5, 5, 5, 7, 5, 7, 5 ],
	[ 8, 9, 5, 9, 7, 5, 9, 5, 8, 5, 7, 5, 5, 9, 5, 9 ],
	[ 9, 7, 5, 9, 5, 5, 5, 5, 5, 5, 5, 5, 5, 5, 5, 5 ],
	[ 9, 8, 5, 5, 9, 5, 5, 5, 5, 5, 8, 5, 9, 9, 5, 5 ],
	[ 9, 5, 5, 8, 5, 5, 9, 5, 8, 5, 7, 5, 5, 5, 5, 8 ]
],
"objects": [
	{
		"x": -1760,
		"y": -3296,
		"type": "HAUNTED_TREE"
	}
],
"lastModified": 1730128888352,
"isMultiplayer": true
}