{
"x": 1,
"y": 1,
"biomeType": "HAUNTED",
"tileData": [
	[ 5, 9, 5, 9, 5, 5, 9, 9, 5, 7, 5, 5, 8, 9, 5, 7 ],
	[ 5, 7, 5, 5, 9, 5, 5, 9, 5, 9, 9, 5, 5, 5, 5, 5 ],
	[ 5, 7, 5, 7, 5, 5, 7, 5, 5, 5, 5, 5, 5, 5, 5, 5 ],
	[ 7, 5, 5, 9, 9, 7, 5, 5, 9, 5, 5, 5, 5, 9, 5, 5 ],
	[ 5, 5, 5, 7, 5, 5, 7, 5, 5, 5, 5, 5, 9, 9, 9, 7 ],
	[ 9, 8, 7, 7, 5, 5, 9, 5, 5, 7, 5, 7, 5, 5, 9, 9 ],
	[ 9, 9, 7, 5, 5, 7, 5, 7, 7, 9, 5, 9, 9, 9, 8, 5 ],
	[ 5, 5, 5, 5, 9, 5, 5, 9, 9, 5, 7, 5, 5, 5, 5, 9 ],
	[ 5, 5, 5, 5, 5, 5, 9, 5, 5, 5, 5, 5, 7, 5, 5, 9 ],
	[ 5, 5, 5, 5, 5, 8, 5, 5, 7, 5, 5, 9, 9, 5, 5, 5 ],
	[ 5, 7, 7, 5, 5, 5, 9, 9, 5, 9, 9, 5, 9, 5, 7, 5 ],
	[ 5, 9, 7, 5, 5, 5, 9, 7, 9, 7, 7, 5, 9, 9, 5, 5 ],
	[ 5, 7, 5, 5, 5, 5, 8, 5, 8, 5, 5, 5, 5, 5, 5, 9 ],
	[ 9, 7, 7, 7, 5, 5, 5, 9, 5, 5, 5, 5, 5, 5, 9, 5 ],
	[ 5, 5, 5, 9, 5, 5, 5, 5, 5, 5, 5, 5, 5, 7, 5, 9 ],
	[ 5, 7, 9, 9, 8, 5, 9, 9, 9, 5, 9, 5, 8, 5, 5, 7 ]
],
"objects": [
	{
		"x": 608,
		"y": 704,
		"type": "HAUNTED_TREE"
	},
	{
		"x": 768,
		"y": 608,
		"type": "HAUNTED_TREE"
	},
	{
		"x": 832,
		"y": 768,
		"type": "HAUNTED_TREE"
	}
],
"lastModified": 1730127108207,
"isMultiplayer": true
}