{
"x": -11,
"y": 1,
"biomeType": "HAUNTED",
"tileData": [
	[ 5, 5, 5, 5, 5, 9, 5, 5, 7, 5, 9, 5, 5, 7, 5, 9 ],
	[ 9, 8, 5, 9, 9, 9, 5, 5, 5, 5, 5, 5, 9, 7, 5, 7 ],
	[ 5, 5, 5, 7, 5, 7, 5, 5, 5, 5, 8, 5, 5, 5, 5, 8 ],
	[ 5, 5, 5, 7, 7, 9, 7, 5, 7, 5, 5, 9, 5, 8, 5, 5 ],
	[ 5, 5, 5, 5, 5, 5, 7, 5, 7, 5, 7, 5, 5, 5, 9, 5 ],
	[ 9, 7, 5, 5, 5, 5, 5, 8, 5, 5, 5, 5, 5, 5, 5, 5 ],
	[ 5, 9, 5, 5, 5, 5, 7, 9, 5, 5, 9, 5, 5, 9, 8, 5 ],
	[ 7, 7, 5, 9, 9, 5, 5, 9, 9, 5, 5, 8, 5, 5, 5, 5 ],
	[ 7, 9, 7, 5, 5, 5, 9, 5, 9, 5, 5, 5, 5, 5, 5, 5 ],
	[ 5, 7, 7, 5, 9, 7, 5, 5, 5, 9, 9, 9, 5, 5, 9, 5 ],
	[ 5, 7, 7, 8, 5, 5, 9, 7, 5, 5, 8, 7, 5, 9, 5, 5 ],
	[ 5, 9, 5, 5, 5, 5, 5, 5, 5, 9, 7, 5, 9, 5, 5, 7 ],
	[ 5, 5, 9, 5, 9, 9, 5, 5, 5, 9, 5, 5, 5, 5, 5, 9 ],
	[ 9, 5, 7, 5, 5, 5, 5, 8, 5, 5, 5, 8, 9, 9, 5, 5 ],
	[ 7, 5, 5, 9, 5, 8, 5, 5, 9, 5, 5, 5, 5, 8, 5, 5 ],
	[ 5, 5, 5, 7, 5, 5, 5, 5, 5, 5, 9, 9, 5, 5, 5, 7 ]
],
"lastModified": 1730134601014,
"isMultiplayer": true
}