{
"x": -13,
"y": 2,
"biomeType": "HAUNTED",
"tileData": [
	[ 5, 5, 5, 5, 5, 7, 5, 5, 5, 9, 5, 5, 7, 9, 5, 5 ],
	[ 5, 5, 9, 9, 5, 5, 9, 5, 5, 5, 7, 5, 7, 7, 5, 5 ],
	[ 5, 5, 7, 9, 5, 5, 9, 5, 9, 9, 9, 5, 5, 5, 9, 9 ],
	[ 7, 7, 5, 5, 5, 5, 5, 5, 9, 5, 9, 5, 7, 7, 7, 5 ],
	[ 9, 5, 9, 5, 5, 7, 5, 9, 5, 5, 5, 7, 5, 7, 5, 5 ],
	[ 7, 5, 5, 5, 7, 8, 5, 5, 5, 9, 5, 9, 7, 5, 5, 9 ],
	[ 5, 7, 5, 9, 5, 5, 9, 5, 9, 7, 5, 5, 5, 5, 5, 7 ],
	[ 5, 5, 5, 9, 5, 9, 9, 9, 5, 5, 5, 8, 5, 5, 5, 9 ],
	[ 5, 9, 9, 5, 9, 5, 5, 5, 9, 5, 7, 5, 9, 9, 5, 9 ],
	[ 9, 9, 5, 5, 9, 9, 5, 5, 5, 7, 5, 5, 5, 9, 9, 5 ],
	[ 5, 5, 7, 5, 5, 5, 9, 5, 9, 7, 5, 9, 9, 5, 5, 7 ],
	[ 5, 9, 5, 5, 5, 8, 9, 7, 5, 9, 5, 5, 5, 5, 5, 5 ],
	[ 7, 7, 5, 9, 7, 5, 5, 5, 5, 9, 9, 5, 9, 7, 5, 5 ],
	[ 8, 5, 5, 9, 7, 5, 9, 5, 5, 5, 5, 5, 8, 5, 7, 5 ],
	[ 9, 5, 5, 5, 5, 5, 5, 7, 5, 5, 9, 7, 5, 5, 5, 7 ],
	[ 9, 9, 5, 9, 7, 5, 9, 5, 9, 5, 9, 5, 5, 5, 7, 7 ]
],
"objects": [
	{
		"x": -6464,
		"y": 1184,
		"type": "HAUNTED_TREE"
	}
],
"lastModified": 1730134596109,
"isMultiplayer": true
}