{
"x": -12,
"y": 2,
"biomeType": "PLAINS",
"tileData": [
	[ 1, 1, 10, 1, 1, 1, 1, 1, 1, 1, 1, 1, 1, 1, 1, 1 ],
	[ 1, 1, 10, 1, 10, 1, 1, 1, 1, 1, 1, 1, 1, 10, 1, 1 ],
	[ 1, 1, 1, 10, 1, 1, 1, 1, 1, 1, 1, 1, 1, 1, 1, 1 ],
	[ 1, 10, 1, 1, 1, 1, 1, 10, 1, 1, 1, 10, 1, 1, 10, 1 ],
	[ 10, 1, 10, 1, 1, 1, 1, 1, 1, 1, 10, 1, 1, 10, 1, 10 ],
	[ 1, 1, 10, 1, 10, 1, 1, 1, 1, 10, 10, 1, 1, 1, 1, 1 ],
	[ 1, 1, 1, 1, 1, 1, 1, 1, 10, 1, 1, 1, 1, 1, 1, 1 ],
	[ 1, 1, 1, 1, 1, 1, 1, 1, 1, 1, 1, 1, 1, 1, 10, 1 ],
	[ 1, 1, 10, 1, 1, 1, 10, 1, 1, 10, 10, 10, 1, 1, 10, 1 ],
	[ 1, 10, 1, 1, 1, 1, 1, 1, 1, 1, 10, 1, 10, 1, 1, 1 ],
	[ 1, 1, 1, 1, 1, 1, 1, 1, 1, 10, 1, 1, 1, 1, 10, 1 ],
	[ 1, 1, 1, 1, 1, 1, 1, 1, 1, 10, 1, 1, 1, 1, 1, 1 ],
	[ 1, 10, 1, 1, 1, 1, 1, 1, 1, 10, 1, 1, 1, 1, 1, 1 ],
	[ 1, 1, 1, 1, 10, 1, 1, 1, 1, 1, 1, 10, 1, 1, 1, 1 ],
	[ 1, 1, 1, 10, 1, 1, 10, 1, 1, 1, 1, 1, 1, 10, 1, 1 ],
	[ 1, 1, 1, 1, 1, 1, 1, 1, 1, 1, 1, 10, 1, 1, 1, 1 ]
],
"objects": [
	{
		"x": -5888,
		"y": 1056,
		"type": "POKEBALL"
	},
	{
		"x": -5984,
		"y": 1216,
		"type": "POKEBALL"
	},
	{
		"x": -5728,
		"y": 1504,
		"type": "POKEBALL"
	},
	{
		"x": -5792,
		"y": 1088,
		"type": "POKEBALL"
	},
	{
		"x": -5728,
		"y": 1184,
		"type": "POKEBALL"
	},
	{
		"x": -5824,
		"y": 1184,
		"type": "POKEBALL"
	},
	{
		"x": -5792,
		"y": 1344,
		"type": "POKEBALL"
	},
	{
		"x": -5792,
		"y": 1248,
		"type": "POKEBALL"
	},
	{
		"x": -6048,
		"y": 1216,
		"type": "POKEBALL"
	}
],
"lastModified": 1730134599777,
"isMultiplayer": true
}