{
"x": -16,
"y": -1,
"biomeType": "HAUNTED",
"tileData": [
	[ 7, 5, 9, 7, 5, 5, 8, 5, 5, 9, 5, 5, 5, 5, 7, 5 ],
	[ 9, 5, 5, 5, 5, 5, 5, 5, 5, 9, 9, 8, 5, 7, 5, 5 ],
	[ 5, 5, 5, 5, 5, 9, 7, 5, 5, 5, 5, 8, 7, 7, 5, 5 ],
	[ 5, 5, 5, 5, 5, 9, 5, 5, 5, 7, 9, 7, 5, 9, 5, 5 ],
	[ 5, 8, 7, 9, 5, 7, 5, 5, 5, 5, 8, 8, 5, 5, 5, 5 ],
	[ 5, 5, 9, 5, 5, 9, 9, 7, 5, 5, 5, 5, 9, 8, 5, 9 ],
	[ 5, 5, 9, 9, 5, 5, 9, 5, 5, 9, 9, 7, 5, 5, 5, 5 ],
	[ 9, 9, 7, 8, 7, 5, 8, 9, 5, 9, 5, 5, 5, 8, 5, 5 ],
	[ 5, 7, 7, 5, 9, 9, 7, 5, 9, 5, 5, 7, 5, 5, 5, 9 ],
	[ 5, 5, 5, 5, 5, 5, 5, 5, 9, 8, 5, 9, 5, 5, 5, 5 ],
	[ 7, 5, 9, 5, 5, 5, 5, 5, 5, 5, 9, 9, 9, 9, 5, 5 ],
	[ 5, 7, 9, 5, 5, 7, 9, 5, 5, 9, 7, 5, 9, 5, 9, 5 ],
	[ 5, 5, 5, 5, 5, 5, 5, 5, 5, 5, 9, 8, 9, 8, 9, 5 ],
	[ 7, 7, 8, 5, 5, 5, 9, 7, 5, 5, 8, 9, 8, 5, 5, 9 ],
	[ 8, 9, 9, 5, 5, 5, 5, 5, 9, 5, 5, 9, 5, 9, 9, 5 ],
	[ 5, 5, 9, 9, 5, 9, 5, 9, 9, 9, 5, 5, 9, 5, 5, 5 ]
],
"objects": [
	{
		"x": -8128,
		"y": -416,
		"type": "HAUNTED_TREE"
	}
],
"lastModified": 1730134512194,
"isMultiplayer": true
}