{
"x": -4,
"y": 3,
"biomeType": "PLAINS",
"tileData": [
	[ 1, 1, 1, 1, 10, 1, 1, 1, 1, 1, 1, 10, 1, 1, 10, 1 ],
	[ 1, 10, 1, 1, 1, 1, 1, 1, 10, 1, 1, 1, 1, 1, 1, 1 ],
	[ 1, 10, 10, 1, 1, 10, 1, 10, 10, 10, 1, 1, 1, 1, 1, 10 ],
	[ 1, 1, 10, 1, 10, 1, 10, 1, 10, 1, 1, 1, 1, 10, 1, 1 ],
	[ 1, 1, 10, 1, 1, 1, 1, 1, 1, 1, 1, 1, 1, 1, 1, 1 ],
	[ 1, 1, 1, 1, 1, 10, 10, 10, 10, 1, 1, 10, 1, 1, 1, 1 ],
	[ 10, 1, 1, 1, 1, 1, 1, 10, 1, 1, 10, 10, 1, 1, 10, 1 ],
	[ 1, 1, 1, 1, 1, 1, 1, 1, 1, 1, 1, 1, 1, 1, 10, 1 ],
	[ 1, 1, 1, 1, 1, 1, 1, 1, 1, 10, 1, 1, 1, 1, 1, 1 ],
	[ 1, 1, 1, 1, 1, 1, 1, 10, 10, 1, 10, 1, 1, 10, 1, 1 ],
	[ 10, 1, 1, 1, 1, 1, 1, 10, 1, 1, 1, 1, 1, 1, 1, 1 ],
	[ 10, 1, 1, 1, 1, 1, 1, 1, 10, 10, 1, 1, 1, 1, 10, 1 ],
	[ 1, 1, 1, 10, 1, 1, 1, 1, 1, 1, 1, 1, 1, 1, 1, 1 ],
	[ 10, 1, 1, 10, 1, 1, 10, 1, 1, 1, 1, 1, 1, 1, 1, 10 ],
	[ 1, 1, 1, 1, 10, 1, 1, 1, 1, 10, 1, 1, 1, 1, 10, 1 ],
	[ 1, 1, 10, 1, 1, 10, 1, 10, 1, 1, 10, 1, 1, 1, 1, 1 ]
],
"objects": [
	{
		"x": -1856,
		"y": 1600,
		"type": "TREE"
	}
],
"lastModified": 1730134593191,
"isMultiplayer": true
}