{
"x": -7,
"y": -2,
"biomeType": "HAUNTED",
"tileData": [
	[ 5, 5, 9, 5, 5, 5, 5, 5, 5, 5, 7, 7, 5, 5, 7, 5 ],
	[ 5, 5, 5, 5, 5, 5, 5, 5, 5, 9, 5, 5, 5, 7, 5, 5 ],
	[ 5, 5, 9, 5, 5, 5, 5, 7, 7, 5, 5, 9, 5, 5, 5, 5 ],
	[ 5, 5, 5, 5, 9, 5, 5, 5, 5, 5, 5, 5, 5, 5, 8, 7 ],
	[ 5, 5, 7, 5, 5, 5, 5, 5, 8, 5, 7, 8, 5, 5, 9, 9 ],
	[ 5, 9, 7, 5, 5, 5, 7, 5, 9, 5, 9, 8, 8, 9, 5, 7 ],
	[ 7, 9, 5, 7, 5, 9, 8, 9, 5, 5, 5, 5, 9, 5, 7, 7 ],
	[ 5, 5, 7, 5, 5, 5, 9, 8, 7, 8, 9, 5, 9, 5, 9, 5 ],
	[ 5, 5, 5, 5, 5, 5, 5, 7, 5, 7, 5, 8, 9, 7, 5, 5 ],
	[ 5, 7, 5, 5, 8, 5, 7, 5, 5, 5, 9, 7, 9, 5, 5, 9 ],
	[ 5, 5, 5, 9, 7, 5, 5, 5, 8, 9, 7, 5, 5, 5, 5, 5 ],
	[ 5, 5, 5, 9, 5, 7, 5, 9, 7, 5, 7, 5, 5, 5, 5, 7 ],
	[ 7, 5, 5, 5, 5, 5, 7, 5, 5, 5, 5, 7, 5, 8, 5, 9 ],
	[ 5, 5, 5, 5, 5, 7, 9, 5, 9, 7, 7, 5, 5, 9, 5, 5 ],
	[ 7, 5, 5, 5, 9, 5, 5, 5, 5, 9, 5, 9, 5, 9, 5, 9 ],
	[ 5, 5, 8, 5, 5, 9, 5, 5, 9, 9, 9, 5, 9, 5, 5, 7 ]
],
"objects": [
	{
		"x": -3456,
		"y": -704,
		"type": "HAUNTED_TREE"
	},
	{
		"x": -3328,
		"y": -800,
		"type": "HAUNTED_TREE"
	}
],
"lastModified": 1730134607284,
"isMultiplayer": true
}