{
"x": -5,
"y": -1,
"biomeType": "HAUNTED",
"tileData": [
	[ 8, 7, 5, 7, 5, 5, 5, 5, 7, 9, 5, 5, 9, 5, 7, 7 ],
	[ 8, 5, 5, 9, 7, 7, 7, 9, 5, 5, 5, 5, 7, 5, 5, 5 ],
	[ 5, 5, 5, 5, 5, 9, 5, 5, 7, 5, 5, 5, 7, 9, 5, 5 ],
	[ 7, 5, 5, 7, 5, 7, 5, 9, 7, 5, 5, 8, 9, 5, 9, 5 ],
	[ 9, 5, 7, 8, 5, 5, 5, 9, 5, 5, 9, 7, 8, 9, 5, 5 ],
	[ 7, 8, 7, 8, 5, 5, 5, 9, 5, 5, 5, 5, 9, 9, 7, 7 ],
	[ 5, 5, 9, 5, 5, 5, 5, 5, 5, 5, 5, 5, 9, 7, 5, 5 ],
	[ 5, 9, 7, 5, 8, 9, 7, 7, 5, 5, 5, 5, 5, 9, 5, 5 ],
	[ 7, 5, 5, 9, 5, 5, 5, 5, 9, 5, 5, 9, 7, 5, 5, 5 ],
	[ 5, 5, 5, 5, 5, 5, 5, 7, 9, 5, 5, 5, 8, 9, 5, 7 ],
	[ 5, 5, 9, 5, 5, 5, 5, 7, 5, 5, 5, 5, 5, 5, 5, 5 ],
	[ 5, 5, 9, 5, 9, 5, 5, 5, 7, 5, 5, 5, 7, 7, 5, 5 ],
	[ 5, 5, 7, 8, 5, 5, 7, 5, 5, 5, 5, 5, 7, 7, 5, 5 ],
	[ 7, 5, 5, 5, 5, 7, 5, 7, 7, 5, 5, 5, 5, 5, 5, 5 ],
	[ 7, 9, 5, 5, 5, 7, 5, 9, 5, 9, 5, 5, 5, 5, 9, 5 ],
	[ 5, 5, 5, 5, 7, 5, 9, 5, 9, 5, 7, 7, 8, 9, 5, 5 ]
],
"objects": [
	{
		"x": -2336,
		"y": -416,
		"type": "HAUNTED_TREE"
	}
],
"lastModified": 1730134463511,
"isMultiplayer": true
}