{
"x": -15,
"y": -3,
"biomeType": "HAUNTED",
"tileData": [
	[ 5, 9, 5, 5, 5, 8, 5, 8, 5, 5, 5, 5, 5, 9, 7, 5 ],
	[ 5, 5, 5, 9, 5, 5, 9, 8, 9, 5, 5, 5, 5, 5, 8, 7 ],
	[ 9, 9, 5, 5, 5, 5, 5, 9, 7, 9, 9, 8, 5, 9, 5, 5 ],
	[ 7, 7, 5, 5, 9, 9, 5, 5, 9, 5, 8, 8, 7, 5, 9, 9 ],
	[ 5, 5, 5, 5, 9, 5, 5, 5, 5, 5, 5, 5, 9, 7, 9, 9 ],
	[ 7, 5, 7, 9, 5, 5, 5, 5, 7, 5, 8, 5, 5, 5, 5, 5 ],
	[ 5, 5, 8, 8, 5, 9, 7, 5, 5, 5, 5, 5, 5, 9, 5, 5 ],
	[ 9, 5, 5, 5, 5, 5, 5, 5, 5, 5, 9, 5, 9, 5, 5, 5 ],
	[ 5, 9, 5, 5, 5, 9, 5, 5, 5, 5, 7, 5, 7, 9, 5, 5 ],
	[ 5, 5, 5, 5, 9, 7, 5, 5, 9, 5, 5, 5, 9, 5, 5, 5 ],
	[ 5, 5, 5, 9, 7, 9, 5, 5, 5, 5, 9, 5, 5, 5, 5, 5 ],
	[ 5, 9, 5, 7, 9, 9, 5, 5, 5, 5, 5, 9, 7, 5, 5, 9 ],
	[ 9, 9, 9, 7, 5, 5, 5, 5, 7, 5, 5, 9, 5, 5, 7, 5 ],
	[ 5, 9, 8, 5, 7, 5, 5, 9, 5, 5, 5, 5, 9, 5, 5, 7 ],
	[ 5, 9, 5, 5, 5, 5, 5, 5, 5, 5, 5, 5, 5, 9, 5, 5 ],
	[ 9, 5, 9, 5, 5, 5, 5, 5, 9, 5, 9, 5, 5, 7, 5, 7 ]
],
"objects": [
	{
		"x": -7296,
		"y": -1280,
		"type": "HAUNTED_TREE"
	}
],
"lastModified": 1730134515319,
"isMultiplayer": true
}