{
"x": -8,
"y": -2,
"biomeType": "HAUNTED",
"tileData": [
	[ 5, 5, 9, 5, 5, 5, 5, 5, 5, 5, 9, 5, 5, 5, 5, 7 ],
	[ 9, 5, 5, 5, 5, 9, 9, 5, 9, 5, 5, 8, 9, 9, 5, 5 ],
	[ 5, 5, 5, 9, 5, 7, 5, 5, 9, 5, 5, 5, 9, 9, 9, 5 ],
	[ 7, 8, 9, 5, 5, 7, 5, 5, 5, 5, 5, 5, 5, 5, 5, 5 ],
	[ 5, 5, 9, 5, 5, 7, 8, 7, 5, 5, 9, 5, 5, 9, 5, 9 ],
	[ 5, 7, 5, 9, 7, 5, 9, 7, 5, 5, 9, 5, 5, 9, 7, 5 ],
	[ 9, 5, 5, 5, 5, 5, 5, 7, 5, 9, 5, 9, 7, 7, 8, 5 ],
	[ 5, 5, 9, 9, 8, 5, 5, 5, 5, 5, 8, 5, 7, 5, 7, 5 ],
	[ 9, 5, 5, 5, 5, 5, 8, 5, 5, 5, 9, 9, 5, 5, 9, 5 ],
	[ 7, 9, 5, 7, 7, 8, 5, 7, 9, 8, 5, 9, 5, 5, 7, 7 ],
	[ 5, 5, 7, 5, 5, 5, 9, 5, 5, 5, 5, 5, 5, 5, 9, 9 ],
	[ 5, 5, 9, 9, 5, 9, 5, 7, 9, 9, 5, 5, 5, 7, 5, 7 ],
	[ 5, 7, 5, 9, 5, 5, 5, 5, 5, 5, 8, 5, 7, 9, 5, 5 ],
	[ 5, 5, 9, 9, 5, 7, 5, 5, 5, 9, 5, 5, 5, 5, 5, 9 ],
	[ 9, 9, 9, 7, 5, 5, 5, 9, 5, 7, 5, 9, 8, 7, 5, 5 ],
	[ 9, 7, 5, 5, 5, 9, 9, 5, 5, 5, 5, 5, 5, 5, 5, 5 ]
],
"objects": [
	{
		"x": -4000,
		"y": -864,
		"type": "HAUNTED_TREE"
	}
],
"lastModified": 1730134604886,
"isMultiplayer": true
}