{
"x": -8,
"y": 3,
"biomeType": "PLAINS",
"tileData": [
	[ 1, 1, 1, 1, 1, 1, 1, 1, 1, 1, 1, 10, 10, 1, 1, 10 ],
	[ 1, 1, 1, 10, 1, 1, 1, 1, 10, 1, 1, 1, 1, 1, 1, 1 ],
	[ 1, 1, 1, 1, 1, 1, 1, 1, 1, 1, 10, 1, 10, 1, 1, 1 ],
	[ 10, 1, 1, 1, 1, 1, 10, 1, 1, 10, 1, 1, 1, 1, 1, 1 ],
	[ 1, 1, 10, 1, 1, 10, 1, 1, 1, 1, 10, 1, 1, 1, 1, 1 ],
	[ 1, 1, 1, 1, 1, 10, 1, 1, 1, 1, 10, 1, 1, 1, 10, 1 ],
	[ 1, 1, 1, 1, 1, 1, 1, 1, 1, 1, 1, 1, 1, 1, 10, 1 ],
	[ 1, 1, 1, 10, 1, 1, 1, 1, 1, 1, 10, 1, 1, 10, 10, 1 ],
	[ 1, 1, 1, 1, 1, 1, 10, 1, 1, 1, 1, 1, 1, 1, 10, 10 ],
	[ 1, 1, 1, 1, 1, 1, 1, 1, 1, 1, 1, 10, 1, 1, 1, 1 ],
	[ 1, 1, 1, 1, 1, 1, 1, 1, 1, 10, 10, 10, 1, 1, 10, 1 ],
	[ 1, 1, 1, 1, 1, 1, 1, 1, 10, 1, 10, 10, 1, 1, 1, 1 ],
	[ 1, 10, 1, 1, 1, 1, 1, 1, 1, 10, 1, 10, 1, 1, 1, 1 ],
	[ 1, 1, 10, 1, 1, 1, 1, 1, 1, 1, 1, 1, 1, 10, 1, 1 ],
	[ 1, 1, 1, 1, 10, 1, 1, 10, 1, 1, 1, 1, 1, 1, 1, 1 ],
	[ 10, 10, 1, 1, 1, 1, 10, 10, 1, 1, 10, 1, 1, 1, 1, 1 ]
],
"objects": [
	{
		"x": -3808,
		"y": 1696,
		"type": "POKEBALL"
	},
	{
		"x": -3904,
		"y": 1856,
		"type": "POKEBALL"
	},
	{
		"x": -3808,
		"y": 1568,
		"type": "POKEBALL"
	},
	{
		"x": -3616,
		"y": 1664,
		"type": "POKEBALL"
	},
	{
		"x": -3744,
		"y": 1728,
		"type": "POKEBALL"
	},
	{
		"x": -4096,
		"y": 1856,
		"type": "POKEBALL"
	},
	{
		"x": -3840,
		"y": 1760,
		"type": "POKEBALL"
	},
	{
		"x": -3904,
		"y": 1696,
		"type": "POKEBALL"
	}
],
"lastModified": 1730134604885,
"isMultiplayer": true
}