{
"x": -8,
"y": 1,
"biomeType": "PLAINS",
"tileData": [
	[ 1, 1, 1, 10, 1, 1, 1, 1, 10, 10, 1, 1, 1, 1, 1, 1 ],
	[ 1, 1, 1, 1, 1, 1, 1, 10, 1, 10, 1, 1, 10, 1, 10, 1 ],
	[ 1, 1, 1, 1, 1, 1, 1, 1, 1, 1, 1, 1, 1, 1, 1, 1 ],
	[ 1, 1, 1, 10, 1, 1, 1, 1, 10, 1, 1, 1, 1, 1, 1, 1 ],
	[ 1, 10, 1, 10, 10, 1, 1, 10, 1, 1, 1, 1, 1, 1, 1, 10 ],
	[ 1, 1, 10, 1, 1, 1, 1, 1, 1, 1, 1, 10, 10, 1, 10, 1 ],
	[ 1, 1, 1, 1, 1, 1, 10, 1, 1, 1, 10, 1, 1, 1, 10, 1 ],
	[ 1, 1, 1, 1, 1, 1, 1, 10, 1, 1, 1, 1, 1, 1, 10, 10 ],
	[ 1, 10, 1, 1, 1, 1, 1, 1, 1, 1, 1, 1, 1, 1, 1, 1 ],
	[ 1, 1, 1, 10, 1, 1, 1, 1, 1, 1, 10, 1, 1, 1, 1, 1 ],
	[ 10, 1, 1, 1, 10, 1, 10, 1, 1, 1, 10, 1, 1, 1, 10, 1 ],
	[ 1, 1, 1, 1, 1, 10, 1, 1, 1, 10, 10, 1, 10, 1, 1, 10 ],
	[ 1, 1, 1, 10, 1, 10, 10, 1, 1, 1, 1, 1, 1, 10, 1, 1 ],
	[ 1, 1, 1, 1, 1, 10, 1, 1, 1, 1, 1, 1, 10, 10, 1, 1 ],
	[ 10, 10, 10, 1, 10, 10, 1, 1, 1, 10, 1, 1, 1, 1, 1, 1 ],
	[ 10, 1, 1, 10, 1, 1, 1, 1, 1, 1, 1, 1, 1, 1, 1, 10 ]
],
"objects": [
	{
		"x": -4096,
		"y": 672,
		"type": "POKEBALL"
	},
	{
		"x": -3840,
		"y": 672,
		"type": "POKEBALL"
	},
	{
		"x": -3968,
		"y": 768,
		"type": "POKEBALL"
	},
	{
		"x": -3808,
		"y": 800,
		"type": "POKEBALL"
	},
	{
		"x": -3968,
		"y": 704,
		"type": "POKEBALL"
	},
	{
		"x": -4064,
		"y": 544,
		"type": "POKEBALL"
	},
	{
		"x": -4032,
		"y": 832,
		"type": "POKEBALL"
	},
	{
		"x": -3680,
		"y": 576,
		"type": "POKEBALL"
	},
	{
		"x": -4032,
		"y": 640,
		"type": "POKEBALL"
	}
],
"lastModified": 1730134604888,
"isMultiplayer": true
}