{
"x": -7,
"y": 1,
"biomeType": "PLAINS",
"tileData": [
	[ 1, 1, 1, 10, 1, 1, 1, 1, 1, 1, 1, 10, 1, 1, 1, 1 ],
	[ 1, 1, 1, 1, 10, 10, 1, 1, 1, 1, 1, 1, 1, 1, 1, 1 ],
	[ 1, 1, 10, 1, 1, 1, 1, 1, 1, 1, 10, 1, 1, 1, 10, 1 ],
	[ 1, 1, 1, 1, 1, 1, 1, 1, 1, 10, 1, 1, 1, 1, 1, 1 ],
	[ 1, 10, 1, 10, 1, 10, 1, 1, 1, 1, 1, 1, 1, 1, 1, 1 ],
	[ 1, 10, 1, 1, 1, 1, 10, 10, 1, 1, 1, 1, 1, 1, 10, 1 ],
	[ 1, 10, 10, 1, 1, 1, 1, 10, 1, 1, 1, 1, 1, 1, 1, 1 ],
	[ 1, 1, 10, 1, 1, 10, 1, 1, 1, 1, 1, 1, 10, 10, 10, 1 ],
	[ 1, 1, 1, 1, 10, 1, 1, 1, 10, 1, 1, 1, 1, 1, 10, 10 ],
	[ 1, 10, 1, 1, 1, 10, 1, 10, 1, 10, 1, 1, 1, 1, 1, 1 ],
	[ 1, 1, 1, 1, 1, 1, 1, 10, 1, 1, 1, 10, 1, 10, 1, 10 ],
	[ 1, 1, 1, 1, 10, 1, 1, 1, 1, 1, 10, 1, 1, 1, 1, 1 ],
	[ 1, 1, 1, 1, 1, 1, 1, 1, 1, 10, 1, 10, 1, 1, 1, 10 ],
	[ 1, 10, 1, 10, 10, 1, 10, 1, 10, 10, 1, 1, 1, 1, 1, 1 ],
	[ 1, 10, 1, 10, 1, 10, 1, 1, 1, 1, 1, 1, 1, 1, 10, 1 ],
	[ 1, 10, 1, 1, 1, 1, 1, 10, 10, 1, 10, 1, 1, 10, 1, 1 ]
],
"objects": [
	{
		"x": -3264,
		"y": 576,
		"type": "TREE"
	},
	{
		"x": -3328,
		"y": 928,
		"type": "POKEBALL"
	},
	{
		"x": -3520,
		"y": 928,
		"type": "POKEBALL"
	},
	{
		"x": -3456,
		"y": 576,
		"type": "POKEBALL"
	},
	{
		"x": -3168,
		"y": 576,
		"type": "POKEBALL"
	}
],
"lastModified": 1730134607282,
"isMultiplayer": true
}