{
"x": -1,
"y": -3,
"biomeType": "HAUNTED",
"tileData": [
	[ 5, 5, 5, 5, 9, 5, 5, 7, 5, 5, 9, 5, 5, 7, 8, 5 ],
	[ 9, 5, 5, 5, 8, 7, 5, 7, 9, 5, 7, 7, 5, 9, 5, 5 ],
	[ 5, 5, 7, 8, 5, 5, 9, 9, 9, 9, 5, 5, 8, 5, 5, 9 ],
	[ 5, 5, 5, 5, 5, 5, 9, 5, 9, 5, 5, 7, 7, 5, 9, 9 ],
	[ 7, 5, 5, 8, 8, 7, 9, 9, 5, 5, 9, 5, 5, 5, 5, 9 ],
	[ 7, 5, 9, 5, 5, 5, 9, 8, 5, 5, 9, 5, 9, 5, 5, 5 ],
	[ 5, 5, 9, 5, 5, 5, 9, 5, 9, 9, 9, 5, 5, 9, 5, 8 ],
	[ 5, 5, 7, 9, 5, 5, 5, 5, 5, 9, 5, 5, 5, 9, 5, 8 ],
	[ 5, 9, 7, 5, 5, 5, 5, 5, 5, 9, 5, 5, 7, 5, 5, 5 ],
	[ 7, 5, 9, 5, 9, 9, 5, 9, 5, 5, 7, 8, 8, 5, 5, 9 ],
	[ 9, 7, 5, 7, 7, 5, 5, 9, 7, 5, 5, 9, 5, 9, 9, 9 ],
	[ 5, 5, 9, 9, 9, 5, 9, 7, 5, 5, 5, 7, 9, 9, 5, 5 ],
	[ 5, 5, 5, 5, 5, 5, 9, 5, 7, 5, 9, 9, 9, 9, 5, 5 ],
	[ 9, 5, 5, 7, 5, 9, 9, 5, 5, 5, 7, 5, 8, 5, 5, 5 ],
	[ 5, 9, 5, 5, 7, 5, 7, 5, 9, 7, 5, 5, 5, 7, 9, 8 ],
	[ 7, 9, 5, 5, 9, 7, 5, 5, 5, 5, 5, 5, 5, 9, 7, 7 ]
],
"lastModified": 1730134445492,
"isMultiplayer": true
}