{
"x": -6,
"y": -5,
"biomeType": "HAUNTED",
"tileData": [
	[ 5, 5, 5, 5, 9, 7, 5, 8, 7, 7, 9, 5, 8, 9, 5, 9 ],
	[ 5, 5, 9, 5, 5, 5, 5, 5, 7, 7, 9, 5, 8, 9, 7, 5 ],
	[ 5, 7, 5, 5, 5, 5, 5, 5, 7, 5, 5, 7, 9, 7, 5, 5 ],
	[ 7, 5, 5, 5, 5, 9, 5, 5, 5, 5, 5, 7, 5, 7, 7, 5 ],
	[ 5, 9, 5, 5, 5, 5, 9, 7, 5, 5, 5, 5, 5, 8, 5, 7 ],
	[ 9, 9, 7, 9, 5, 5, 9, 8, 5, 9, 7, 5, 5, 5, 5, 5 ],
	[ 5, 5, 5, 5, 5, 9, 5, 5, 9, 9, 5, 8, 7, 7, 5, 5 ],
	[ 5, 5, 5, 5, 5, 7, 5, 9, 5, 9, 7, 7, 9, 5, 5, 9 ],
	[ 5, 5, 5, 5, 5, 5, 9, 9, 5, 5, 9, 5, 9, 5, 5, 5 ],
	[ 9, 5, 7, 9, 5, 5, 5, 5, 7, 5, 5, 8, 5, 9, 5, 9 ],
	[ 7, 9, 5, 5, 5, 5, 9, 5, 7, 5, 5, 5, 5, 9, 5, 5 ],
	[ 7, 9, 5, 9, 5, 7, 9, 5, 9, 5, 5, 5, 9, 9, 5, 5 ],
	[ 5, 9, 5, 5, 5, 9, 5, 7, 5, 5, 5, 5, 8, 9, 5, 5 ],
	[ 8, 5, 5, 5, 5, 8, 7, 5, 5, 5, 5, 5, 9, 9, 5, 7 ],
	[ 5, 5, 5, 5, 5, 5, 5, 5, 5, 9, 5, 7, 5, 5, 7, 5 ],
	[ 5, 9, 5, 8, 5, 5, 5, 5, 5, 5, 9, 5, 9, 9, 5, 5 ]
],
"objects": [
	{
		"x": -3008,
		"y": -2304,
		"type": "HAUNTED_TREE"
	}
],
"lastModified": 1730134442419,
"isMultiplayer": true
}