{
"x": 2,
"y": -1,
"biomeType": "HAUNTED",
"tileData": [
	[ 5, 7, 5, 5, 5, 5, 5, 5, 5, 9, 5, 5, 5, 5, 5, 5 ],
	[ 8, 9, 9, 7, 7, 5, 9, 9, 7, 5, 9, 5, 9, 9, 5, 5 ],
	[ 9, 5, 5, 5, 5, 9, 9, 5, 5, 5, 5, 5, 5, 5, 5, 7 ],
	[ 9, 5, 5, 9, 5, 5, 5, 5, 9, 9, 5, 8, 5, 7, 5, 5 ],
	[ 5, 9, 5, 5, 5, 9, 9, 5, 9, 9, 5, 9, 5, 5, 5, 5 ],
	[ 9, 8, 5, 5, 7, 5, 5, 5, 7, 9, 5, 9, 5, 7, 5, 8 ],
	[ 5, 5, 8, 5, 9, 5, 8, 5, 7, 5, 5, 5, 5, 5, 7, 5 ],
	[ 5, 5, 5, 5, 5, 5, 5, 7, 7, 9, 5, 8, 5, 7, 5, 5 ],
	[ 5, 5, 9, 5, 5, 5, 5, 5, 5, 8, 5, 7, 7, 5, 5, 5 ],
	[ 5, 7, 5, 5, 5, 9, 5, 5, 8, 5, 5, 8, 5, 5, 7, 5 ],
	[ 9, 7, 5, 7, 9, 9, 5, 9, 5, 5, 5, 5, 5, 5, 5, 9 ],
	[ 5, 5, 5, 5, 5, 5, 5, 5, 5, 5, 5, 9, 7, 5, 9, 5 ],
	[ 7, 5, 5, 5, 5, 5, 5, 5, 5, 5, 7, 5, 8, 9, 9, 9 ],
	[ 7, 5, 9, 5, 7, 5, 9, 5, 5, 9, 9, 5, 5, 7, 5, 9 ],
	[ 9, 5, 9, 7, 5, 5, 5, 9, 5, 9, 5, 5, 7, 5, 5, 5 ],
	[ 5, 5, 5, 5, 7, 9, 9, 5, 7, 9, 5, 9, 5, 5, 5, 5 ]
],
"objects": [
	{
		"x": 1344,
		"y": -256,
		"type": "HAUNTED_TREE"
	},
	{
		"x": 1408,
		"y": -288,
		"type": "HAUNTED_TREE"
	}
],
"lastModified": 1730127108212,
"isMultiplayer": true
}