{
"x": -8,
"y": 2,
"biomeType": "PLAINS",
"tileData": [
	[ 10, 1, 10, 1, 1, 1, 1, 1, 1, 1, 10, 1, 1, 1, 1, 10 ],
	[ 1, 1, 1, 1, 10, 1, 10, 1, 10, 1, 10, 1, 10, 1, 1, 10 ],
	[ 1, 1, 1, 1, 1, 1, 1, 10, 1, 1, 1, 1, 1, 1, 1, 1 ],
	[ 1, 1, 1, 1, 1, 1, 1, 10, 1, 1, 1, 1, 10, 1, 1, 1 ],
	[ 1, 10, 10, 1, 10, 1, 1, 1, 10, 1, 10, 1, 1, 10, 1, 1 ],
	[ 1, 1, 10, 1, 10, 10, 1, 1, 1, 10, 1, 1, 10, 1, 1, 1 ],
	[ 1, 10, 1, 10, 1, 10, 1, 1, 1, 1, 1, 1, 10, 1, 10, 1 ],
	[ 1, 10, 1, 1, 10, 1, 10, 1, 1, 1, 10, 10, 1, 10, 1, 1 ],
	[ 1, 1, 1, 1, 1, 1, 1, 1, 1, 1, 1, 1, 1, 1, 10, 10 ],
	[ 1, 1, 1, 10, 1, 1, 10, 1, 1, 10, 1, 1, 1, 1, 1, 1 ],
	[ 1, 1, 1, 1, 1, 1, 1, 1, 1, 1, 1, 1, 1, 10, 1, 1 ],
	[ 10, 1, 1, 1, 1, 1, 1, 1, 1, 1, 1, 1, 10, 1, 1, 1 ],
	[ 1, 1, 1, 1, 1, 1, 1, 1, 1, 10, 1, 1, 1, 10, 1, 10 ],
	[ 1, 10, 1, 1, 1, 1, 1, 1, 1, 1, 1, 1, 10, 1, 10, 10 ],
	[ 1, 1, 1, 1, 1, 1, 10, 10, 1, 1, 1, 1, 1, 1, 1, 1 ],
	[ 1, 1, 10, 1, 10, 10, 1, 1, 10, 10, 1, 10, 1, 1, 1, 1 ]
],
"objects": [
	{
		"x": -4064,
		"y": 1088,
		"type": "POKEBALL"
	},
	{
		"x": -3936,
		"y": 1120,
		"type": "POKEBALL"
	},
	{
		"x": -3648,
		"y": 1120,
		"type": "POKEBALL"
	},
	{
		"x": -3936,
		"y": 1056,
		"type": "POKEBALL"
	},
	{
		"x": -3904,
		"y": 1344,
		"type": "POKEBALL"
	},
	{
		"x": -4096,
		"y": 1248,
		"type": "POKEBALL"
	},
	{
		"x": -3648,
		"y": 1024,
		"type": "POKEBALL"
	},
	{
		"x": -4032,
		"y": 1504,
		"type": "POKEBALL"
	}
],
"lastModified": 1730134604887,
"isMultiplayer": true
}