{
"x": -5,
"y": -6,
"biomeType": "HAUNTED",
"tileData": [
	[ 8, 5, 5, 5, 5, 5, 5, 5, 5, 7, 7, 7, 9, 9, 7, 7 ],
	[ 5, 5, 8, 5, 5, 5, 5, 5, 9, 5, 5, 9, 9, 5, 9, 8 ],
	[ 7, 5, 9, 9, 8, 5, 5, 9, 8, 5, 5, 5, 9, 5, 9, 5 ],
	[ 9, 5, 9, 8, 7, 8, 5, 5, 5, 9, 5, 5, 9, 5, 5, 5 ],
	[ 5, 9, 9, 5, 5, 5, 5, 5, 5, 9, 5, 5, 5, 5, 5, 8 ],
	[ 9, 5, 7, 5, 9, 5, 7, 5, 5, 5, 5, 7, 9, 9, 9, 9 ],
	[ 9, 7, 5, 5, 5, 5, 5, 9, 5, 5, 9, 5, 5, 7, 8, 9 ],
	[ 5, 5, 5, 7, 5, 5, 5, 5, 5, 5, 8, 9, 5, 7, 5, 5 ],
	[ 5, 8, 5, 5, 9, 5, 5, 5, 5, 5, 5, 5, 5, 5, 5, 9 ],
	[ 9, 7, 5, 5, 7, 5, 5, 8, 5, 9, 7, 9, 5, 5, 5, 5 ],
	[ 7, 5, 5, 5, 5, 5, 5, 5, 5, 7, 8, 5, 9, 5, 7, 5 ],
	[ 8, 5, 7, 5, 9, 5, 5, 9, 5, 9, 5, 5, 5, 7, 9, 9 ],
	[ 9, 5, 7, 5, 9, 8, 5, 7, 9, 7, 5, 9, 5, 9, 7, 5 ],
	[ 5, 5, 5, 7, 5, 5, 9, 5, 5, 5, 7, 9, 7, 5, 7, 5 ],
	[ 5, 5, 5, 7, 5, 7, 5, 5, 7, 9, 5, 9, 5, 5, 5, 5 ],
	[ 5, 5, 7, 5, 7, 5, 5, 5, 9, 9, 7, 5, 9, 5, 9, 5 ]
],
"objects": [
	{
		"x": -2208,
		"y": -3008,
		"type": "HAUNTED_TREE"
	}
],
"lastModified": 1730134428638,
"isMultiplayer": true
}