{
"x": 1,
"y": -4,
"biomeType": "HAUNTED",
"tileData": [
	[ 5, 8, 5, 5, 5, 9, 7, 5, 9, 5, 5, 9, 8, 7, 5, 5 ],
	[ 9, 5, 7, 9, 5, 5, 9, 5, 9, 5, 5, 5, 5, 5, 5, 5 ],
	[ 5, 5, 5, 8, 5, 9, 5, 5, 5, 7, 7, 5, 5, 5, 5, 8 ],
	[ 9, 5, 5, 5, 9, 5, 5, 9, 5, 5, 9, 9, 5, 5, 5, 5 ],
	[ 5, 9, 7, 5, 5, 8, 5, 9, 5, 9, 9, 5, 5, 5, 8, 5 ],
	[ 5, 5, 7, 5, 9, 5, 5, 5, 5, 5, 5, 5, 9, 5, 5, 5 ],
	[ 5, 5, 5, 5, 5, 9, 5, 5, 7, 5, 9, 5, 5, 9, 5, 9 ],
	[ 9, 5, 5, 5, 5, 5, 5, 7, 8, 5, 9, 5, 5, 5, 5, 9 ],
	[ 5, 5, 9, 8, 5, 9, 9, 5, 5, 5, 8, 5, 9, 5, 9, 5 ],
	[ 5, 5, 9, 9, 5, 7, 9, 5, 7, 5, 5, 9, 5, 5, 5, 5 ],
	[ 5, 5, 5, 5, 9, 5, 5, 5, 5, 5, 7, 5, 5, 5, 5, 5 ],
	[ 5, 9, 7, 9, 5, 5, 7, 9, 5, 5, 5, 5, 5, 9, 7, 5 ],
	[ 8, 5, 5, 5, 5, 9, 5, 5, 9, 7, 5, 9, 5, 9, 5, 5 ],
	[ 8, 5, 7, 9, 7, 9, 9, 5, 5, 5, 9, 5, 7, 5, 5, 7 ],
	[ 9, 5, 5, 5, 9, 5, 5, 8, 5, 9, 7, 9, 5, 5, 5, 9 ],
	[ 7, 5, 5, 9, 9, 9, 5, 5, 9, 9, 9, 5, 9, 7, 5, 9 ]
],
"objects": [
	{
		"x": 800,
		"y": -1920,
		"type": "HAUNTED_TREE"
	}
],
"lastModified": 1730135519254,
"isMultiplayer": true
}