{
"x": -1,
"y": 3,
"biomeType": "PLAINS",
"tileData": [
	[ 1, 1, 10, 1, 1, 1, 1, 10, 1, 1, 1, 1, 10, 1, 1, 1 ],
	[ 1, 1, 1, 1, 1, 1, 1, 1, 1, 1, 1, 10, 1, 1, 1, 10 ],
	[ 1, 1, 1, 1, 1, 1, 1, 1, 1, 1, 10, 1, 10, 1, 1, 10 ],
	[ 1, 10, 1, 1, 1, 1, 1, 1, 1, 1, 1, 10, 1, 1, 1, 1 ],
	[ 10, 10, 1, 1, 10, 10, 1, 1, 1, 10, 1, 1, 1, 1, 1, 1 ],
	[ 1, 1, 1, 1, 1, 1, 10, 10, 1, 1, 1, 1, 1, 1, 1, 10 ],
	[ 1, 1, 1, 1, 1, 1, 10, 10, 10, 1, 1, 10, 1, 1, 10, 1 ],
	[ 1, 1, 1, 1, 1, 1, 1, 1, 1, 1, 1, 1, 1, 1, 1, 1 ],
	[ 1, 1, 1, 1, 1, 1, 1, 1, 1, 10, 1, 1, 1, 1, 1, 10 ],
	[ 1, 1, 10, 10, 1, 1, 1, 10, 1, 1, 1, 1, 1, 10, 1, 1 ],
	[ 1, 1, 1, 10, 1, 1, 1, 1, 1, 1, 1, 10, 10, 1, 1, 1 ],
	[ 1, 1, 10, 1, 10, 10, 1, 1, 1, 1, 1, 1, 1, 1, 1, 1 ],
	[ 1, 1, 1, 1, 1, 1, 1, 1, 1, 1, 1, 1, 1, 10, 1, 1 ],
	[ 1, 1, 1, 1, 1, 1, 10, 1, 1, 10, 1, 10, 1, 1, 1, 10 ],
	[ 1, 10, 1, 1, 1, 1, 1, 1, 1, 1, 1, 1, 1, 1, 1, 1 ],
	[ 1, 1, 1, 1, 10, 1, 1, 1, 1, 1, 10, 1, 1, 1, 10, 1 ]
],
"objects": [
	{
		"x": -160,
		"y": 1888,
		"type": "TREE"
	}
],
"lastModified": 1730134611214,
"isMultiplayer": true
}