{
"x": -3,
"y": -2,
"biomeType": "HAUNTED",
"tileData": [
	[ 9, 5, 5, 9, 5, 5, 9, 7, 7, 5, 7, 5, 5, 5, 5, 5 ],
	[ 5, 5, 5, 5, 9, 5, 7, 5, 5, 5, 5, 5, 7, 5, 5, 5 ],
	[ 5, 7, 5, 5, 5, 9, 9, 9, 5, 5, 5, 7, 5, 5, 7, 5 ],
	[ 7, 5, 7, 7, 5, 5, 5, 7, 5, 5, 5, 9, 9, 5, 7, 5 ],
	[ 5, 7, 5, 5, 9, 5, 5, 5, 5, 7, 5, 5, 9, 9, 8, 7 ],
	[ 9, 5, 5, 5, 5, 5, 9, 7, 5, 7, 5, 5, 5, 9, 5, 5 ],
	[ 5, 5, 9, 8, 5, 5, 7, 9, 7, 5, 5, 7, 5, 5, 5, 9 ],
	[ 7, 5, 5, 5, 5, 5, 5, 5, 7, 5, 5, 5, 5, 5, 5, 8 ],
	[ 7, 7, 5, 5, 9, 8, 5, 5, 8, 5, 5, 9, 5, 5, 8, 5 ],
	[ 9, 9, 5, 9, 7, 7, 9, 5, 5, 8, 5, 5, 5, 5, 5, 5 ],
	[ 5, 5, 5, 9, 5, 5, 5, 5, 5, 5, 9, 5, 7, 5, 7, 5 ],
	[ 5, 5, 5, 9, 9, 5, 7, 5, 5, 7, 5, 5, 5, 7, 5, 9 ],
	[ 5, 5, 5, 5, 5, 5, 9, 9, 5, 5, 7, 7, 5, 7, 5, 7 ],
	[ 5, 5, 5, 7, 7, 5, 5, 5, 7, 5, 9, 5, 9, 5, 5, 7 ],
	[ 9, 5, 9, 5, 9, 5, 5, 5, 7, 7, 7, 5, 5, 5, 9, 5 ],
	[ 5, 5, 5, 5, 9, 5, 5, 5, 5, 5, 9, 5, 5, 5, 5, 5 ]
],
"objects": [
	{
		"x": -1440,
		"y": -704,
		"type": "HAUNTED_TREE"
	}
],
"lastModified": 1730134456071,
"isMultiplayer": true
}