{
"x": -4,
"y": -6,
"biomeType": "HAUNTED",
"tileData": [
	[ 7, 5, 5, 5, 7, 5, 5, 5, 5, 5, 5, 9, 7, 9, 7, 5 ],
	[ 5, 7, 7, 5, 9, 5, 9, 5, 5, 5, 5, 9, 5, 7, 5, 5 ],
	[ 9, 5, 5, 5, 5, 5, 5, 9, 5, 5, 5, 5, 9, 5, 5, 5 ],
	[ 8, 9, 5, 9, 5, 7, 7, 7, 5, 5, 9, 9, 5, 5, 7, 5 ],
	[ 5, 5, 9, 5, 5, 5, 5, 7, 5, 5, 9, 8, 9, 5, 5, 5 ],
	[ 5, 7, 5, 5, 7, 8, 5, 5, 5, 5, 7, 8, 5, 5, 9, 5 ],
	[ 5, 5, 9, 9, 5, 7, 9, 9, 9, 5, 7, 7, 7, 5, 5, 5 ],
	[ 5, 5, 5, 7, 5, 9, 5, 5, 5, 5, 5, 5, 9, 5, 5, 5 ],
	[ 5, 5, 5, 5, 5, 9, 5, 5, 5, 5, 5, 5, 5, 9, 5, 5 ],
	[ 5, 5, 5, 8, 5, 7, 5, 5, 5, 5, 5, 5, 9, 7, 5, 5 ],
	[ 5, 5, 7, 5, 5, 5, 7, 5, 5, 7, 5, 5, 8, 7, 7, 5 ],
	[ 9, 5, 5, 5, 9, 9, 7, 5, 5, 9, 5, 5, 5, 9, 9, 5 ],
	[ 5, 5, 9, 8, 5, 5, 9, 5, 5, 5, 7, 9, 5, 5, 5, 7 ],
	[ 5, 5, 5, 7, 5, 9, 7, 7, 5, 5, 9, 9, 5, 5, 5, 5 ],
	[ 5, 9, 5, 5, 5, 7, 7, 5, 9, 8, 7, 8, 7, 9, 9, 5 ],
	[ 5, 7, 5, 5, 5, 5, 5, 9, 5, 8, 9, 7, 5, 5, 5, 5 ]
],
"objects": [
	{
		"x": -1728,
		"y": -2720,
		"type": "HAUNTED_TREE"
	},
	{
		"x": -1696,
		"y": -2912,
		"type": "HAUNTED_TREE"
	}
],
"lastModified": 1730134428633,
"isMultiplayer": true
}