{
"x": 1,
"y": -5,
"biomeType": "HAUNTED",
"tileData": [
	[ 5, 9, 9, 9, 7, 7, 9, 7, 5, 8, 9, 8, 5, 5, 9, 5 ],
	[ 7, 5, 5, 5, 5, 5, 5, 7, 5, 9, 9, 5, 5, 5, 5, 9 ],
	[ 5, 5, 8, 5, 5, 5, 5, 5, 5, 5, 7, 5, 5, 9, 9, 5 ],
	[ 5, 8, 5, 5, 9, 9, 5, 8, 5, 7, 9, 5, 5, 9, 8, 5 ],
	[ 5, 5, 5, 5, 7, 5, 9, 5, 5, 5, 5, 9, 7, 5, 9, 5 ],
	[ 5, 5, 9, 5, 5, 8, 5, 5, 5, 5, 5, 5, 5, 9, 5, 5 ],
	[ 5, 5, 9, 5, 7, 5, 5, 5, 5, 5, 5, 9, 9, 9, 9, 5 ],
	[ 5, 5, 5, 9, 9, 5, 9, 5, 7, 5, 5, 9, 5, 5, 5, 5 ],
	[ 8, 5, 5, 5, 5, 9, 5, 8, 5, 8, 5, 5, 5, 5, 5, 5 ],
	[ 9, 9, 5, 7, 9, 5, 9, 9, 5, 5, 5, 7, 5, 5, 5, 5 ],
	[ 5, 5, 5, 5, 5, 5, 7, 5, 5, 7, 5, 5, 5, 7, 5, 7 ],
	[ 5, 7, 5, 5, 5, 5, 5, 5, 9, 7, 5, 5, 5, 7, 5, 5 ],
	[ 5, 5, 9, 5, 5, 5, 5, 5, 5, 9, 5, 5, 9, 5, 5, 5 ],
	[ 9, 5, 9, 5, 5, 5, 5, 9, 7, 5, 7, 5, 8, 5, 5, 7 ],
	[ 5, 9, 5, 9, 5, 5, 5, 5, 5, 5, 9, 5, 5, 5, 5, 9 ],
	[ 9, 9, 7, 5, 7, 5, 5, 5, 5, 9, 5, 5, 5, 7, 9, 9 ]
],
"objects": [
	{
		"x": 864,
		"y": -2496,
		"type": "HAUNTED_TREE"
	}
],
"lastModified": 1730135509863,
"isMultiplayer": true
}