{
"x": 2,
"y": -5,
"biomeType": "HAUNTED",
"tileData": [
	[ 5, 5, 5, 5, 5, 5, 9, 5, 7, 5, 5, 5, 5, 9, 5, 5 ],
	[ 5, 9, 9, 5, 7, 5, 9, 9, 5, 5, 5, 9, 5, 5, 7, 5 ],
	[ 5, 7, 5, 5, 5, 7, 9, 5, 5, 5, 5, 7, 5, 7, 5, 5 ],
	[ 9, 7, 5, 5, 7, 5, 9, 5, 5, 5, 9, 7, 5, 5, 5, 5 ],
	[ 8, 9, 5, 5, 5, 5, 7, 7, 5, 5, 7, 8, 5, 9, 5, 5 ],
	[ 9, 5, 5, 9, 5, 7, 5, 5, 7, 5, 5, 5, 5, 5, 5, 5 ],
	[ 9, 9, 5, 9, 7, 5, 7, 5, 8, 5, 9, 5, 7, 5, 5, 5 ],
	[ 7, 7, 5, 5, 5, 9, 9, 9, 5, 5, 9, 7, 5, 5, 5, 5 ],
	[ 7, 5, 5, 5, 5, 5, 5, 5, 9, 5, 9, 5, 7, 7, 9, 5 ],
	[ 9, 5, 5, 5, 7, 9, 5, 7, 5, 9, 5, 5, 7, 5, 5, 7 ],
	[ 5, 5, 7, 5, 5, 5, 9, 5, 5, 5, 5, 9, 5, 5, 9, 9 ],
	[ 5, 5, 5, 7, 9, 5, 5, 7, 5, 5, 5, 7, 5, 9, 7, 5 ],
	[ 8, 5, 7, 5, 5, 5, 9, 5, 8, 9, 5, 7, 5, 9, 5, 5 ],
	[ 7, 7, 5, 7, 5, 7, 5, 5, 5, 9, 5, 5, 5, 5, 5, 5 ],
	[ 7, 5, 5, 5, 5, 9, 5, 5, 5, 5, 5, 5, 5, 5, 9, 5 ],
	[ 5, 5, 5, 5, 5, 5, 9, 9, 7, 5, 7, 7, 7, 5, 5, 5 ]
],
"objects": [
	{
		"x": 1152,
		"y": -2496,
		"type": "HAUNTED_TREE"
	},
	{
		"x": 1408,
		"y": -2240,
		"type": "HAUNTED_TREE"
	}
],
"lastModified": 1730135509866,
"isMultiplayer": true
}