{
"x": -5,
"y": -7,
"biomeType": "HAUNTED",
"tileData": [
	[ 8, 7, 9, 9, 9, 5, 5, 5, 5, 9, 5, 5, 5, 5, 5, 8 ],
	[ 5, 5, 5, 7, 5, 9, 5, 7, 5, 5, 9, 5, 5, 7, 5, 5 ],
	[ 7, 9, 5, 5, 5, 5, 5, 5, 5, 5, 5, 5, 9, 5, 5, 9 ],
	[ 9, 7, 9, 5, 9, 5, 5, 5, 5, 5, 9, 5, 5, 5, 5, 5 ],
	[ 5, 5, 5, 7, 5, 9, 5, 9, 5, 5, 5, 5, 5, 5, 9, 5 ],
	[ 5, 5, 7, 5, 5, 9, 8, 8, 5, 9, 5, 9, 5, 5, 5, 5 ],
	[ 5, 5, 5, 5, 5, 5, 7, 5, 5, 5, 5, 9, 8, 5, 5, 5 ],
	[ 9, 5, 9, 5, 5, 5, 9, 5, 9, 5, 5, 5, 5, 7, 7, 5 ],
	[ 7, 7, 5, 5, 5, 5, 9, 5, 5, 7, 5, 5, 7, 9, 5, 5 ],
	[ 8, 7, 5, 9, 5, 5, 7, 7, 5, 9, 5, 5, 9, 9, 5, 9 ],
	[ 9, 7, 5, 5, 5, 5, 5, 9, 8, 5, 5, 5, 9, 5, 5, 7 ],
	[ 5, 7, 8, 9, 8, 8, 5, 8, 7, 7, 5, 5, 5, 5, 5, 5 ],
	[ 5, 5, 8, 5, 5, 5, 5, 7, 5, 5, 9, 5, 9, 8, 9, 5 ],
	[ 8, 9, 5, 7, 5, 5, 5, 9, 9, 7, 5, 7, 5, 9, 8, 5 ],
	[ 5, 7, 9, 9, 5, 9, 5, 9, 5, 9, 5, 9, 9, 5, 5, 5 ],
	[ 5, 9, 5, 5, 7, 5, 7, 5, 5, 5, 8, 5, 9, 5, 5, 7 ]
],
"objects": [
	{
		"x": -2496,
		"y": -3392,
		"type": "HAUNTED_TREE"
	}
],
"lastModified": 1730128888344,
"isMultiplayer": true
}