{
"x": -10,
"y": 2,
"biomeType": "PLAINS",
"tileData": [
	[ 10, 1, 1, 1, 1, 1, 1, 10, 1, 1, 1, 1, 1, 1, 10, 1 ],
	[ 1, 1, 10, 1, 1, 1, 1, 10, 1, 1, 1, 1, 1, 1, 1, 1 ],
	[ 1, 1, 10, 10, 1, 1, 1, 1, 1, 1, 1, 10, 1, 1, 1, 1 ],
	[ 1, 1, 1, 1, 1, 1, 1, 1, 1, 1, 1, 1, 1, 1, 1, 1 ],
	[ 10, 1, 1, 1, 1, 1, 1, 1, 10, 1, 1, 10, 1, 1, 10, 1 ],
	[ 1, 10, 1, 1, 1, 10, 10, 1, 1, 1, 1, 1, 1, 1, 1, 1 ],
	[ 1, 1, 1, 1, 1, 1, 1, 1, 1, 1, 1, 10, 1, 1, 1, 1 ],
	[ 10, 1, 1, 1, 1, 1, 10, 1, 1, 1, 10, 10, 1, 1, 10, 1 ],
	[ 10, 1, 10, 1, 1, 10, 1, 1, 1, 1, 1, 1, 1, 1, 1, 1 ],
	[ 1, 10, 1, 1, 1, 1, 1, 1, 1, 10, 1, 1, 1, 10, 1, 1 ],
	[ 1, 1, 1, 1, 1, 1, 10, 1, 10, 1, 1, 1, 10, 1, 10, 1 ],
	[ 1, 1, 1, 10, 10, 10, 1, 1, 10, 10, 1, 1, 1, 1, 10, 1 ],
	[ 10, 10, 1, 1, 1, 10, 1, 1, 1, 1, 10, 1, 1, 1, 1, 1 ],
	[ 1, 10, 1, 1, 1, 1, 1, 1, 10, 1, 1, 1, 1, 1, 1, 10 ],
	[ 10, 1, 1, 1, 1, 10, 1, 10, 1, 1, 1, 1, 1, 1, 10, 10 ],
	[ 1, 10, 1, 1, 1, 1, 1, 10, 1, 1, 1, 1, 1, 1, 10, 1 ]
],
"objects": [
	{
		"x": -4640,
		"y": 1088,
		"type": "POKEBALL"
	},
	{
		"x": -5088,
		"y": 1152,
		"type": "POKEBALL"
	},
	{
		"x": -5120,
		"y": 1504,
		"type": "POKEBALL"
	},
	{
		"x": -4736,
		"y": 1216,
		"type": "POKEBALL"
	},
	{
		"x": -4768,
		"y": 1408,
		"type": "POKEBALL"
	},
	{
		"x": -4896,
		"y": 1184,
		"type": "POKEBALL"
	},
	{
		"x": -4832,
		"y": 1376,
		"type": "POKEBALL"
	},
	{
		"x": -4864,
		"y": 1440,
		"type": "POKEBALL"
	}
],
"lastModified": 1730134601015,
"isMultiplayer": true
}