{
"x": -2,
"y": -7,
"biomeType": "HAUNTED",
"tileData": [
	[ 7, 9, 5, 7, 9, 9, 7, 5, 5, 8, 5, 5, 5, 5, 5, 5 ],
	[ 5, 5, 7, 5, 5, 5, 7, 5, 5, 5, 5, 5, 5, 9, 7, 9 ],
	[ 5, 5, 7, 5, 5, 7, 5, 9, 9, 8, 7, 8, 5, 9, 5, 5 ],
	[ 7, 9, 9, 9, 5, 5, 5, 5, 9, 5, 5, 5, 9, 7, 5, 9 ],
	[ 9, 5, 5, 5, 5, 5, 7, 7, 5, 5, 5, 5, 9, 5, 7, 7 ],
	[ 7, 5, 5, 9, 5, 9, 5, 5, 5, 5, 5, 5, 5, 5, 5, 5 ],
	[ 9, 5, 5, 7, 7, 5, 5, 9, 5, 9, 7, 9, 7, 9, 7, 5 ],
	[ 5, 5, 9, 5, 5, 9, 5, 5, 5, 5, 5, 5, 9, 9, 9, 5 ],
	[ 9, 5, 5, 5, 5, 7, 5, 9, 7, 5, 5, 5, 7, 5, 5, 9 ],
	[ 5, 5, 9, 9, 5, 9, 7, 5, 5, 9, 9, 5, 5, 7, 9, 7 ],
	[ 7, 9, 5, 9, 7, 5, 9, 5, 8, 7, 9, 5, 9, 5, 5, 5 ],
	[ 9, 5, 5, 5, 5, 9, 9, 9, 5, 5, 5, 5, 7, 9, 5, 5 ],
	[ 7, 9, 5, 9, 7, 7, 5, 9, 9, 5, 5, 5, 9, 5, 5, 5 ],
	[ 5, 5, 9, 8, 5, 7, 5, 7, 5, 7, 7, 7, 5, 5, 5, 7 ],
	[ 5, 7, 5, 9, 5, 5, 7, 5, 5, 5, 9, 5, 8, 7, 7, 5 ],
	[ 5, 7, 5, 5, 9, 9, 7, 5, 9, 5, 7, 5, 5, 5, 5, 7 ]
],
"objects": [
	{
		"x": -960,
		"y": -3264,
		"type": "HAUNTED_TREE"
	},
	{
		"x": -864,
		"y": -3488,
		"type": "HAUNTED_TREE"
	}
],
"lastModified": 1730128888354,
"isMultiplayer": true
}