{
"x": 1,
"biomeType": "HAUNTED",
"tileData": [
	[ 7, 5, 5, 9, 5, 5, 5, 9, 7, 7, 5, 7, 9, 5, 5, 5 ],
	[ 5, 5, 7, 5, 5, 5, 5, 9, 7, 5, 5, 5, 9, 5, 5, 5 ],
	[ 5, 5, 8, 5, 5, 9, 5, 5, 7, 7, 5, 7, 5, 5, 7, 5 ],
	[ 9, 5, 9, 7, 7, 5, 5, 9, 5, 5, 5, 5, 5, 5, 8, 5 ],
	[ 5, 5, 5, 7, 9, 7, 5, 7, 5, 8, 5, 5, 5, 7, 5, 5 ],
	[ 9, 5, 8, 5, 5, 9, 7, 5, 5, 9, 5, 5, 9, 5, 9, 9 ],
	[ 9, 5, 5, 5, 5, 5, 5, 5, 5, 5, 5, 5, 9, 5, 5, 5 ],
	[ 8, 7, 9, 5, 5, 5, 5, 5, 5, 5, 9, 8, 9, 5, 9, 7 ],
	[ 9, 5, 7, 9, 5, 5, 9, 5, 5, 5, 7, 5, 5, 5, 5, 5 ],
	[ 5, 5, 7, 5, 9, 7, 5, 9, 5, 8, 8, 7, 5, 9, 5, 5 ],
	[ 5, 5, 5, 5, 9, 7, 7, 5, 5, 5, 5, 9, 9, 5, 5, 5 ],
	[ 5, 5, 5, 5, 5, 7, 5, 5, 8, 9, 5, 9, 5, 7, 5, 5 ],
	[ 7, 9, 7, 5, 9, 5, 7, 5, 5, 5, 7, 7, 5, 5, 5, 5 ],
	[ 9, 5, 9, 7, 8, 5, 5, 5, 9, 5, 5, 5, 5, 9, 9, 5 ],
	[ 9, 7, 9, 9, 7, 5, 7, 5, 9, 7, 9, 5, 7, 7, 5, 5 ],
	[ 5, 5, 8, 5, 5, 5, 5, 5, 5, 5, 9, 7, 7, 5, 8, 7 ]
],
"objects": [
	{
		"x": 672,
		"y": 192,
		"type": "HAUNTED_TREE"
	}
],
"lastModified": 1730127108205,
"isMultiplayer": true
}