{
"y": -4,
"biomeType": "HAUNTED",
"tileData": [
	[ 7, 5, 5, 5, 5, 9, 5, 8, 5, 9, 5, 5, 5, 5, 5, 7 ],
	[ 5, 5, 5, 5, 7, 5, 5, 5, 7, 5, 5, 5, 7, 5, 5, 7 ],
	[ 5, 9, 9, 7, 8, 5, 9, 8, 9, 5, 7, 7, 5, 5, 8, 5 ],
	[ 5, 7, 9, 7, 5, 5, 5, 5, 7, 5, 5, 8, 5, 9, 5, 9 ],
	[ 5, 5, 5, 5, 5, 9, 5, 9, 5, 5, 9, 5, 5, 8, 8, 9 ],
	[ 5, 8, 5, 7, 9, 5, 5, 9, 5, 8, 5, 5, 7, 5, 5, 7 ],
	[ 5, 5, 7, 5, 5, 5, 5, 5, 7, 7, 9, 9, 7, 5, 5, 9 ],
	[ 9, 9, 5, 5, 5, 5, 5, 5, 9, 5, 7, 7, 7, 9, 5, 5 ],
	[ 5, 9, 5, 5, 5, 5, 5, 5, 5, 5, 5, 5, 8, 5, 9, 5 ],
	[ 5, 5, 5, 5, 7, 9, 9, 9, 5, 5, 7, 9, 5, 5, 5, 5 ],
	[ 5, 9, 5, 7, 9, 5, 9, 5, 5, 5, 7, 5, 5, 5, 5, 5 ],
	[ 5, 7, 5, 5, 5, 5, 7, 7, 5, 9, 8, 9, 7, 5, 9, 5 ],
	[ 5, 5, 7, 5, 9, 5, 5, 5, 5, 5, 5, 9, 5, 5, 5, 5 ],
	[ 8, 5, 9, 9, 5, 5, 5, 7, 5, 5, 5, 5, 5, 9, 5, 5 ],
	[ 9, 5, 5, 5, 5, 9, 9, 5, 5, 8, 9, 5, 5, 5, 5, 9 ],
	[ 5, 9, 5, 8, 7, 7, 5, 5, 5, 5, 7, 5, 5, 5, 5, 5 ]
],
"objects": [
	{
		"x": 224,
		"y": -1824,
		"type": "HAUNTED_TREE"
	},
	{
		"x": 384,
		"y": -1984,
		"type": "HAUNTED_TREE"
	}
],
"lastModified": 1730135519253,
"isMultiplayer": true
}