{
"x": -10,
"y": 1,
"biomeType": "PLAINS",
"tileData": [
	[ 1, 1, 10, 1, 1, 1, 1, 1, 1, 10, 1, 10, 1, 1, 1, 10 ],
	[ 1, 10, 1, 1, 10, 1, 1, 1, 1, 1, 1, 1, 1, 1, 1, 1 ],
	[ 1, 1, 1, 1, 1, 1, 10, 1, 1, 1, 1, 1, 1, 1, 1, 1 ],
	[ 1, 1, 1, 1, 1, 10, 1, 1, 1, 1, 1, 1, 1, 1, 1, 1 ],
	[ 1, 1, 1, 1, 1, 1, 1, 1, 10, 10, 1, 10, 1, 10, 10, 1 ],
	[ 1, 1, 1, 1, 1, 1, 10, 1, 1, 1, 1, 1, 1, 1, 1, 1 ],
	[ 10, 1, 1, 1, 1, 1, 10, 1, 10, 1, 1, 1, 1, 1, 1, 1 ],
	[ 1, 1, 1, 1, 1, 1, 1, 1, 10, 1, 1, 1, 10, 1, 1, 1 ],
	[ 1, 1, 1, 1, 10, 1, 10, 10, 1, 1, 1, 1, 1, 1, 1, 1 ],
	[ 10, 1, 1, 1, 10, 1, 10, 10, 1, 1, 1, 1, 10, 1, 10, 1 ],
	[ 1, 1, 10, 10, 1, 10, 1, 1, 1, 1, 1, 1, 1, 10, 1, 1 ],
	[ 1, 1, 1, 1, 1, 1, 10, 1, 1, 1, 1, 1, 1, 1, 1, 1 ],
	[ 1, 1, 1, 1, 10, 1, 1, 1, 1, 1, 1, 1, 1, 1, 1, 1 ],
	[ 1, 1, 1, 1, 1, 1, 1, 1, 1, 1, 1, 1, 1, 1, 1, 10 ],
	[ 1, 1, 1, 10, 10, 1, 1, 1, 1, 1, 1, 1, 1, 1, 1, 1 ],
	[ 1, 1, 1, 1, 1, 1, 1, 1, 1, 1, 1, 1, 1, 10, 1, 1 ]
],
"objects": [
	{
		"x": -4768,
		"y": 800,
		"type": "POKEBALL"
	},
	{
		"x": -4640,
		"y": 672,
		"type": "POKEBALL"
	},
	{
		"x": -5120,
		"y": 672,
		"type": "POKEBALL"
	},
	{
		"x": -5024,
		"y": 928,
		"type": "POKEBALL"
	},
	{
		"x": -4640,
		"y": 800,
		"type": "POKEBALL"
	}
],
"lastModified": 1730134601016,
"isMultiplayer": true
}