{
"x": -3,
"biomeType": "HAUNTED",
"tileData": [
	[ 9, 5, 9, 5, 8, 9, 7, 5, 5, 5, 5, 5, 8, 9, 5, 5 ],
	[ 5, 5, 5, 9, 5, 5, 7, 5, 5, 5, 5, 5, 5, 8, 5, 7 ],
	[ 5, 7, 9, 5, 5, 9, 5, 5, 5, 5, 5, 5, 5, 5, 5, 5 ],
	[ 5, 7, 9, 5, 5, 9, 7, 7, 9, 5, 7, 9, 8, 5, 7, 5 ],
	[ 5, 9, 5, 5, 5, 5, 5, 5, 5, 5, 5, 5, 5, 5, 5, 5 ],
	[ 5, 5, 5, 5, 9, 5, 5, 5, 5, 8, 7, 5, 5, 5, 9, 5 ],
	[ 9, 8, 7, 7, 9, 5, 5, 5, 5, 5, 9, 5, 5, 5, 5, 5 ],
	[ 5, 5, 9, 5, 7, 5, 5, 5, 9, 9, 5, 9, 5, 5, 8, 9 ],
	[ 5, 5, 5, 5, 7, 7, 5, 5, 5, 5, 5, 5, 5, 7, 9, 5 ],
	[ 5, 7, 7, 9, 7, 8, 7, 5, 7, 5, 8, 7, 9, 7, 5, 5 ],
	[ 5, 7, 7, 5, 5, 5, 5, 7, 9, 5, 8, 7, 5, 5, 5, 5 ],
	[ 5, 5, 5, 5, 5, 9, 5, 7, 5, 5, 5, 5, 5, 5, 5, 5 ],
	[ 9, 5, 5, 5, 8, 9, 9, 9, 5, 5, 5, 7, 8, 5, 5, 5 ],
	[ 5, 5, 5, 5, 9, 5, 8, 5, 5, 5, 5, 5, 5, 7, 9, 5 ],
	[ 7, 5, 5, 5, 7, 5, 9, 5, 5, 5, 5, 9, 5, 9, 7, 5 ],
	[ 7, 5, 5, 5, 5, 7, 7, 7, 5, 9, 5, 5, 5, 9, 9, 5 ]
],
"objects": [
	{
		"x": -1280,
		"y": 288,
		"type": "HAUNTED_TREE"
	}
],
"lastModified": 1730134456069,
"isMultiplayer": true
}