{
"x": -4,
"y": 2,
"biomeType": "PLAINS",
"tileData": [
	[ 1, 1, 1, 1, 1, 1, 10, 1, 1, 1, 1, 1, 1, 10, 1, 1 ],
	[ 1, 1, 1, 1, 1, 1, 1, 1, 1, 1, 1, 1, 1, 10, 1, 1 ],
	[ 1, 10, 1, 1, 1, 1, 1, 1, 1, 1, 1, 1, 1, 1, 10, 1 ],
	[ 1, 1, 1, 1, 1, 1, 1, 1, 1, 1, 1, 1, 1, 1, 1, 1 ],
	[ 1, 10, 1, 1, 1, 1, 1, 1, 1, 1, 1, 1, 10, 10, 1, 1 ],
	[ 1, 1, 1, 1, 10, 1, 1, 1, 1, 10, 1, 1, 1, 1, 1, 1 ],
	[ 1, 10, 1, 1, 1, 1, 1, 1, 1, 1, 1, 10, 1, 1, 1, 1 ],
	[ 1, 1, 10, 1, 1, 1, 1, 1, 10, 1, 1, 1, 1, 1, 10, 1 ],
	[ 1, 1, 1, 1, 1, 1, 1, 1, 1, 1, 10, 1, 1, 1, 1, 1 ],
	[ 1, 1, 1, 1, 1, 1, 10, 1, 1, 1, 1, 1, 10, 10, 1, 1 ],
	[ 1, 1, 10, 1, 1, 1, 1, 1, 1, 1, 1, 1, 1, 1, 10, 1 ],
	[ 10, 1, 1, 1, 1, 10, 1, 1, 1, 1, 1, 1, 1, 1, 1, 1 ],
	[ 1, 1, 1, 1, 1, 1, 10, 10, 10, 10, 1, 1, 1, 1, 1, 10 ],
	[ 1, 1, 10, 1, 1, 1, 10, 1, 1, 1, 1, 1, 1, 1, 1, 1 ],
	[ 1, 10, 1, 1, 1, 10, 1, 1, 1, 10, 1, 1, 1, 1, 1, 1 ],
	[ 1, 1, 10, 1, 1, 1, 10, 1, 1, 1, 1, 1, 1, 1, 10, 1 ]
],
"objects": [
	{
		"x": -1664,
		"y": 1120,
		"type": "TREE"
	},
	{
		"x": -1952,
		"y": 1216,
		"type": "POKEBALL"
	},
	{
		"x": -1728,
		"y": 1344,
		"type": "POKEBALL"
	},
	{
		"x": -1696,
		"y": 1056,
		"type": "POKEBALL"
	},
	{
		"x": -2016,
		"y": 1408,
		"type": "POKEBALL"
	},
	{
		"x": -1728,
		"y": 1440,
		"type": "POKEBALL"
	},
	{
		"x": -1824,
		"y": 1376,
		"type": "POKEBALL"
	},
	{
		"x": -1568,
		"y": 1504,
		"type": "POKEBALL"
	}
],
"lastModified": 1730134459676,
"isMultiplayer": true
}