{
"x": -6,
"y": 2,
"biomeType": "PLAINS",
"tileData": [
	[ 1, 1, 10, 10, 1, 1, 1, 1, 1, 1, 1, 1, 1, 1, 1, 1 ],
	[ 1, 1, 1, 1, 1, 1, 1, 10, 1, 10, 1, 1, 1, 1, 10, 1 ],
	[ 1, 10, 1, 10, 1, 1, 1, 1, 1, 1, 1, 1, 1, 1, 1, 1 ],
	[ 1, 1, 1, 1, 1, 10, 1, 1, 1, 1, 1, 10, 10, 1, 1, 1 ],
	[ 1, 1, 10, 1, 1, 1, 1, 1, 1, 1, 10, 10, 10, 10, 10, 10 ],
	[ 1, 1, 1, 1, 1, 1, 1, 1, 1, 1, 1, 10, 1, 1, 1, 10 ],
	[ 1, 1, 10, 1, 1, 10, 1, 1, 1, 1, 10, 1, 1, 1, 1, 1 ],
	[ 10, 1, 1, 1, 1, 1, 1, 1, 1, 1, 1, 10, 1, 10, 1, 1 ],
	[ 10, 1, 1, 1, 1, 1, 1, 1, 1, 1, 10, 10, 1, 1, 10, 1 ],
	[ 1, 1, 10, 1, 10, 1, 1, 1, 1, 1, 1, 1, 1, 1, 1, 1 ],
	[ 1, 10, 10, 1, 1, 1, 1, 1, 1, 10, 10, 1, 1, 10, 10, 1 ],
	[ 1, 1, 1, 10, 1, 1, 1, 1, 1, 1, 1, 10, 1, 10, 10, 1 ],
	[ 10, 1, 1, 1, 1, 10, 1, 1, 1, 1, 1, 10, 1, 10, 1, 10 ],
	[ 1, 1, 1, 1, 1, 1, 10, 1, 1, 1, 1, 1, 1, 1, 1, 1 ],
	[ 1, 1, 1, 1, 1, 10, 10, 1, 1, 1, 1, 1, 1, 10, 1, 1 ],
	[ 1, 1, 1, 1, 1, 1, 1, 1, 1, 1, 1, 10, 10, 1, 1, 1 ]
],
"objects": [
	{
		"x": -2880,
		"y": 1152,
		"type": "TREE"
	},
	{
		"x": -2848,
		"y": 1344,
		"type": "TREE"
	},
	{
		"x": -2720,
		"y": 1216,
		"type": "POKEBALL"
	},
	{
		"x": -2848,
		"y": 1248,
		"type": "POKEBALL"
	},
	{
		"x": -2912,
		"y": 1024,
		"type": "POKEBALL"
	},
	{
		"x": -2976,
		"y": 1120,
		"type": "POKEBALL"
	},
	{
		"x": -3072,
		"y": 1184,
		"type": "POKEBALL"
	}
],
"lastModified": 1730134480759,
"isMultiplayer": true
}