{
"x": -1,
"y": -4,
"biomeType": "HAUNTED",
"tileData": [
	[ 5, 7, 9, 5, 5, 5, 5, 5, 5, 7, 8, 7, 5, 9, 9, 5 ],
	[ 5, 5, 5, 5, 5, 9, 5, 7, 5, 5, 7, 5, 9, 7, 5, 7 ],
	[ 5, 5, 9, 9, 9, 5, 8, 5, 5, 5, 5, 5, 7, 5, 9, 5 ],
	[ 5, 5, 5, 5, 5, 5, 5, 5, 9, 5, 5, 5, 5, 5, 9, 5 ],
	[ 5, 7, 5, 5, 5, 7, 5, 5, 5, 5, 5, 5, 9, 5, 5, 7 ],
	[ 5, 5, 9, 9, 5, 5, 8, 5, 7, 7, 5, 9, 5, 5, 5, 9 ],
	[ 5, 5, 8, 5, 9, 5, 5, 5, 7, 5, 5, 5, 9, 5, 7, 9 ],
	[ 7, 5, 5, 9, 5, 9, 5, 5, 5, 5, 9, 5, 5, 5, 9, 7 ],
	[ 5, 7, 5, 5, 5, 9, 5, 5, 5, 5, 7, 5, 9, 7, 5, 5 ],
	[ 5, 5, 5, 5, 5, 7, 9, 5, 5, 5, 5, 9, 7, 5, 5, 8 ],
	[ 5, 5, 5, 5, 5, 7, 7, 7, 9, 5, 7, 5, 5, 5, 5, 5 ],
	[ 9, 5, 5, 5, 9, 9, 9, 7, 5, 5, 5, 5, 5, 5, 5, 5 ],
	[ 5, 5, 5, 5, 9, 5, 9, 5, 5, 9, 5, 5, 5, 5, 9, 5 ],
	[ 7, 5, 9, 5, 5, 5, 9, 8, 7, 9, 7, 9, 7, 9, 9, 9 ],
	[ 5, 5, 5, 5, 9, 5, 9, 5, 9, 9, 5, 8, 8, 7, 5, 7 ],
	[ 5, 7, 5, 7, 8, 5, 9, 5, 7, 9, 5, 5, 5, 5, 9, 5 ]
],
"objects": [
	{
		"x": -256,
		"y": -1984,
		"type": "HAUNTED_TREE"
	}
],
"lastModified": 1730135519252,
"isMultiplayer": true
}