{
"x": -2,
"y": -6,
"biomeType": "HAUNTED",
"tileData": [
	[ 9, 9, 5, 9, 5, 5, 5, 5, 5, 8, 7, 5, 5, 5, 5, 5 ],
	[ 5, 5, 9, 5, 7, 5, 5, 5, 7, 9, 9, 5, 5, 5, 5, 5 ],
	[ 9, 5, 5, 9, 5, 7, 5, 5, 5, 5, 9, 7, 9, 7, 7, 8 ],
	[ 5, 5, 7, 5, 7, 8, 7, 5, 5, 7, 5, 5, 5, 5, 5, 7 ],
	[ 7, 5, 5, 9, 5, 7, 5, 5, 5, 5, 9, 8, 9, 5, 5, 5 ],
	[ 5, 5, 5, 5, 7, 9, 7, 5, 5, 5, 7, 5, 5, 5, 5, 5 ],
	[ 7, 5, 5, 5, 5, 5, 9, 9, 8, 5, 9, 5, 5, 5, 5, 5 ],
	[ 9, 9, 5, 5, 5, 8, 5, 5, 5, 8, 5, 7, 7, 5, 5, 5 ],
	[ 5, 8, 5, 5, 8, 9, 5, 9, 5, 5, 5, 5, 5, 5, 9, 5 ],
	[ 9, 5, 5, 5, 8, 5, 5, 9, 7, 5, 5, 5, 5, 5, 5, 5 ],
	[ 5, 7, 5, 5, 5, 5, 9, 5, 5, 9, 5, 7, 8, 5, 5, 7 ],
	[ 5, 9, 5, 5, 7, 9, 5, 5, 9, 5, 5, 5, 5, 5, 5, 8 ],
	[ 5, 7, 5, 9, 5, 5, 5, 5, 5, 5, 9, 8, 8, 5, 9, 5 ],
	[ 9, 5, 5, 7, 5, 5, 5, 9, 7, 9, 9, 5, 5, 5, 5, 9 ],
	[ 5, 9, 5, 7, 5, 9, 9, 5, 5, 7, 5, 5, 9, 5, 8, 5 ],
	[ 5, 5, 5, 9, 5, 5, 5, 5, 9, 5, 9, 5, 5, 9, 5, 5 ]
],
"objects": [
	{
		"x": -640,
		"y": -2816,
		"type": "HAUNTED_TREE"
	}
],
"lastModified": 1730134428635,
"isMultiplayer": true
}