{
"x": -11,
"y": 2,
"biomeType": "PLAINS",
"tileData": [
	[ 1, 1, 1, 1, 1, 10, 10, 1, 10, 1, 1, 1, 1, 1, 1, 1 ],
	[ 1, 1, 10, 1, 1, 1, 1, 1, 1, 10, 1, 1, 1, 1, 10, 1 ],
	[ 1, 10, 1, 1, 1, 1, 1, 10, 1, 10, 1, 1, 10, 1, 1, 10 ],
	[ 1, 1, 1, 10, 1, 1, 1, 1, 1, 1, 1, 1, 1, 10, 10, 1 ],
	[ 1, 1, 10, 1, 10, 1, 1, 1, 1, 1, 1, 1, 10, 1, 10, 1 ],
	[ 10, 1, 1, 10, 10, 1, 1, 1, 1, 1, 1, 1, 1, 10, 1, 10 ],
	[ 10, 1, 1, 1, 1, 1, 1, 1, 1, 1, 10, 1, 1, 1, 1, 1 ],
	[ 1, 10, 1, 1, 1, 10, 10, 1, 1, 1, 1, 1, 1, 1, 1, 1 ],
	[ 1, 1, 10, 1, 1, 1, 1, 1, 1, 1, 1, 1, 1, 1, 1, 10 ],
	[ 1, 1, 1, 1, 10, 10, 1, 10, 10, 1, 1, 1, 1, 1, 1, 1 ],
	[ 1, 1, 1, 1, 1, 10, 1, 10, 1, 1, 1, 1, 1, 1, 1, 1 ],
	[ 1, 1, 10, 1, 1, 1, 1, 10, 1, 1, 10, 1, 1, 1, 1, 1 ],
	[ 10, 1, 1, 1, 1, 1, 1, 1, 1, 1, 1, 1, 1, 1, 1, 1 ],
	[ 1, 10, 1, 1, 10, 10, 1, 1, 1, 1, 1, 1, 1, 1, 1, 1 ],
	[ 1, 1, 1, 1, 1, 1, 10, 10, 1, 10, 1, 1, 10, 1, 1, 1 ],
	[ 1, 1, 10, 1, 1, 10, 1, 1, 1, 1, 1, 10, 1, 1, 1, 1 ]
],
"objects": [
	{
		"x": -5536,
		"y": 1280,
		"type": "POKEBALL"
	},
	{
		"x": -5248,
		"y": 1216,
		"type": "POKEBALL"
	},
	{
		"x": -5248,
		"y": 1472,
		"type": "POKEBALL"
	},
	{
		"x": -5248,
		"y": 1120,
		"type": "POKEBALL"
	},
	{
		"x": -5344,
		"y": 1216,
		"type": "POKEBALL"
	},
	{
		"x": -5312,
		"y": 1376,
		"type": "POKEBALL"
	},
	{
		"x": -5312,
		"y": 1280,
		"type": "POKEBALL"
	},
	{
		"x": -5440,
		"y": 1216,
		"type": "POKEBALL"
	}
],
"lastModified": 1730134601014,
"isMultiplayer": true
}