{
"x": -2,
"y": -4,
"biomeType": "HAUNTED",
"tileData": [
	[ 7, 9, 7, 7, 5, 5, 5, 8, 7, 5, 5, 5, 5, 9, 5, 5 ],
	[ 8, 7, 7, 5, 5, 5, 9, 5, 5, 9, 5, 7, 5, 5, 5, 5 ],
	[ 5, 5, 5, 5, 7, 8, 5, 5, 5, 9, 5, 5, 5, 5, 9, 5 ],
	[ 9, 5, 5, 5, 5, 5, 9, 9, 9, 5, 9, 7, 5, 5, 5, 9 ],
	[ 7, 5, 9, 7, 5, 9, 9, 9, 9, 5, 5, 9, 9, 9, 8, 7 ],
	[ 5, 7, 5, 5, 9, 7, 5, 7, 9, 7, 5, 9, 9, 5, 5, 5 ],
	[ 9, 5, 5, 5, 7, 9, 9, 5, 9, 5, 5, 5, 5, 5, 8, 9 ],
	[ 5, 5, 5, 5, 9, 5, 5, 5, 5, 5, 5, 5, 5, 7, 5, 5 ],
	[ 5, 5, 5, 7, 9, 5, 9, 5, 5, 7, 5, 5, 5, 5, 7, 5 ],
	[ 8, 5, 9, 5, 8, 5, 9, 7, 5, 8, 8, 5, 5, 7, 5, 5 ],
	[ 7, 8, 9, 7, 5, 9, 9, 8, 5, 8, 5, 5, 5, 5, 5, 5 ],
	[ 9, 9, 9, 9, 5, 5, 5, 5, 5, 9, 5, 5, 5, 5, 5, 5 ],
	[ 9, 5, 5, 5, 9, 5, 5, 5, 5, 5, 5, 5, 5, 5, 5, 9 ],
	[ 5, 9, 5, 5, 9, 5, 9, 5, 5, 9, 5, 5, 5, 5, 5, 5 ],
	[ 9, 5, 7, 5, 5, 9, 5, 5, 9, 9, 5, 5, 7, 5, 7, 5 ],
	[ 5, 5, 9, 5, 5, 5, 5, 5, 5, 5, 5, 5, 7, 5, 5, 5 ]
],
"objects": [
	{
		"x": -672,
		"y": -1696,
		"type": "HAUNTED_TREE"
	}
],
"lastModified": 1730135519251,
"isMultiplayer": true
}