{
"x": -7,
"y": -3,
"biomeType": "HAUNTED",
"tileData": [
	[ 5, 8, 7, 5, 9, 5, 5, 9, 5, 5, 5, 5, 5, 9, 5, 5 ],
	[ 5, 8, 7, 9, 5, 9, 5, 9, 5, 9, 5, 5, 7, 5, 5, 5 ],
	[ 5, 9, 7, 9, 5, 7, 7, 5, 9, 9, 5, 5, 5, 8, 9, 5 ],
	[ 5, 5, 7, 5, 9, 7, 9, 7, 9, 9, 7, 9, 9, 7, 7, 9 ],
	[ 8, 5, 5, 9, 5, 5, 9, 5, 5, 7, 5, 5, 8, 5, 7, 7 ],
	[ 7, 5, 5, 5, 5, 5, 9, 5, 9, 5, 5, 5, 5, 5, 7, 5 ],
	[ 5, 5, 7, 5, 7, 5, 9, 7, 5, 9, 7, 5, 5, 5, 7, 5 ],
	[ 5, 5, 5, 5, 5, 7, 7, 5, 5, 5, 7, 5, 8, 5, 5, 9 ],
	[ 5, 5, 5, 7, 5, 5, 5, 5, 9, 8, 5, 5, 9, 5, 9, 8 ],
	[ 5, 5, 5, 5, 9, 5, 9, 5, 5, 8, 5, 5, 9, 5, 9, 7 ],
	[ 9, 9, 5, 9, 5, 5, 5, 9, 7, 5, 8, 5, 8, 5, 5, 5 ],
	[ 5, 5, 5, 5, 5, 7, 5, 5, 9, 5, 7, 7, 9, 5, 5, 5 ],
	[ 5, 5, 5, 5, 5, 7, 5, 5, 7, 9, 5, 5, 5, 5, 5, 5 ],
	[ 9, 5, 8, 7, 5, 5, 5, 5, 8, 5, 5, 7, 5, 5, 7, 5 ],
	[ 7, 5, 9, 5, 5, 5, 5, 5, 5, 8, 5, 5, 7, 5, 5, 9 ],
	[ 5, 9, 5, 9, 9, 5, 5, 9, 5, 7, 5, 5, 7, 5, 9, 5 ]
],
"objects": [
	{
		"x": -3296,
		"y": -1472,
		"type": "HAUNTED_TREE"
	}
],
"lastModified": 1730134601014,
"isMultiplayer": true
}