{
"x": -4,
"y": -3,
"biomeType": "HAUNTED",
"tileData": [
	[ 5, 7, 5, 5, 9, 9, 8, 5, 5, 9, 7, 5, 5, 7, 5, 7 ],
	[ 7, 9, 5, 5, 7, 5, 8, 8, 5, 9, 9, 5, 5, 9, 9, 5 ],
	[ 8, 5, 5, 5, 7, 5, 5, 8, 5, 5, 7, 5, 5, 9, 5, 9 ],
	[ 9, 5, 5, 5, 5, 5, 8, 5, 5, 5, 5, 5, 5, 5, 9, 7 ],
	[ 7, 5, 8, 5, 7, 9, 9, 9, 5, 5, 5, 5, 5, 5, 5, 5 ],
	[ 9, 5, 5, 7, 7, 9, 7, 5, 9, 5, 9, 9, 8, 9, 5, 5 ],
	[ 5, 5, 5, 5, 5, 9, 5, 5, 7, 5, 5, 5, 7, 5, 5, 9 ],
	[ 5, 9, 8, 5, 9, 5, 5, 5, 9, 5, 5, 5, 9, 5, 5, 5 ],
	[ 5, 5, 5, 8, 5, 9, 5, 5, 5, 9, 7, 9, 9, 7, 5, 5 ],
	[ 5, 7, 9, 9, 9, 7, 5, 5, 5, 5, 5, 5, 5, 8, 5, 9 ],
	[ 9, 5, 7, 5, 5, 5, 7, 5, 7, 5, 8, 8, 9, 9, 7, 5 ],
	[ 5, 9, 8, 9, 5, 9, 9, 9, 5, 9, 5, 5, 7, 5, 7, 5 ],
	[ 9, 5, 5, 7, 9, 5, 5, 5, 7, 5, 5, 5, 8, 5, 9, 5 ],
	[ 5, 5, 9, 5, 5, 5, 5, 9, 5, 5, 5, 5, 5, 9, 5, 9 ],
	[ 5, 5, 7, 5, 5, 5, 9, 9, 5, 9, 5, 9, 5, 5, 5, 7 ],
	[ 7, 5, 5, 8, 7, 9, 9, 9, 5, 9, 9, 7, 5, 5, 5, 5 ]
],
"objects": [
	{
		"x": -1952,
		"y": -1216,
		"type": "HAUNTED_TREE"
	},
	{
		"x": -1888,
		"y": -1472,
		"type": "HAUNTED_TREE"
	}
],
"lastModified": 1730134601012,
"isMultiplayer": true
}