{
"x": -5,
"y": 2,
"biomeType": "PLAINS",
"tileData": [
	[ 1, 1, 1, 10, 1, 1, 1, 1, 1, 10, 1, 1, 1, 1, 1, 1 ],
	[ 1, 1, 1, 1, 1, 1, 1, 1, 1, 1, 1, 1, 1, 1, 10, 1 ],
	[ 1, 1, 10, 1, 1, 1, 1, 10, 1, 1, 10, 1, 1, 1, 1, 10 ],
	[ 1, 1, 1, 1, 1, 1, 1, 10, 10, 1, 1, 1, 1, 1, 1, 10 ],
	[ 1, 10, 10, 1, 1, 10, 1, 1, 1, 1, 1, 10, 1, 1, 1, 1 ],
	[ 1, 1, 1, 1, 1, 1, 10, 1, 1, 1, 1, 10, 1, 1, 10, 1 ],
	[ 1, 1, 1, 1, 1, 1, 1, 10, 1, 10, 1, 1, 10, 10, 1, 10 ],
	[ 1, 1, 1, 1, 10, 1, 10, 1, 1, 1, 1, 1, 10, 1, 1, 1 ],
	[ 10, 1, 1, 1, 1, 1, 1, 1, 10, 1, 10, 1, 1, 1, 1, 10 ],
	[ 1, 10, 1, 1, 1, 10, 10, 1, 1, 10, 1, 1, 10, 1, 1, 1 ],
	[ 1, 10, 1, 1, 1, 10, 1, 1, 1, 1, 10, 1, 1, 1, 10, 1 ],
	[ 1, 10, 1, 10, 1, 1, 1, 1, 1, 1, 1, 10, 1, 1, 1, 1 ],
	[ 10, 1, 1, 10, 10, 10, 10, 1, 1, 1, 1, 1, 10, 1, 1, 1 ],
	[ 1, 1, 10, 1, 1, 1, 10, 1, 1, 10, 1, 1, 1, 1, 1, 1 ],
	[ 10, 1, 1, 10, 1, 1, 10, 1, 10, 1, 1, 1, 10, 10, 1, 1 ],
	[ 1, 1, 1, 1, 1, 1, 1, 1, 10, 1, 10, 1, 1, 1, 1, 1 ]
],
"objects": [
	{
		"x": -2400,
		"y": 1184,
		"type": "TREE"
	},
	{
		"x": -2240,
		"y": 1248,
		"type": "POKEBALL"
	},
	{
		"x": -2528,
		"y": 1120,
		"type": "POKEBALL"
	},
	{
		"x": -2432,
		"y": 1344,
		"type": "POKEBALL"
	},
	{
		"x": -2176,
		"y": 1344,
		"type": "POKEBALL"
	},
	{
		"x": -2464,
		"y": 1184,
		"type": "POKEBALL"
	},
	{
		"x": -2176,
		"y": 1088,
		"type": "POKEBALL"
	},
	{
		"x": -2144,
		"y": 1248,
		"type": "POKEBALL"
	}
],
"lastModified": 1730134463513,
"isMultiplayer": true
}