{
"x": -3,
"y": -1,
"biomeType": "HAUNTED",
"tileData": [
	[ 9, 9, 5, 5, 5, 5, 8, 9, 7, 5, 5, 5, 5, 5, 5, 5 ],
	[ 9, 5, 9, 9, 5, 5, 7, 7, 8, 5, 5, 7, 9, 5, 5, 5 ],
	[ 5, 5, 5, 5, 5, 7, 5, 5, 5, 5, 5, 5, 5, 5, 9, 5 ],
	[ 5, 5, 5, 5, 5, 5, 5, 8, 5, 5, 9, 5, 9, 5, 9, 9 ],
	[ 7, 5, 9, 5, 5, 9, 5, 8, 7, 5, 8, 5, 7, 5, 7, 5 ],
	[ 9, 5, 5, 5, 5, 5, 5, 5, 5, 7, 5, 5, 9, 7, 7, 5 ],
	[ 8, 5, 5, 5, 7, 9, 5, 5, 9, 5, 7, 5, 5, 5, 9, 5 ],
	[ 5, 9, 7, 5, 5, 5, 5, 5, 5, 5, 9, 9, 5, 9, 9, 9 ],
	[ 7, 7, 5, 5, 5, 5, 9, 5, 5, 5, 5, 9, 9, 5, 5, 5 ],
	[ 5, 5, 5, 5, 7, 5, 9, 5, 5, 8, 5, 5, 5, 5, 9, 8 ],
	[ 8, 5, 8, 5, 9, 9, 5, 5, 5, 5, 5, 5, 5, 5, 7, 5 ],
	[ 7, 9, 5, 5, 5, 9, 7, 5, 5, 7, 8, 5, 9, 5, 9, 5 ],
	[ 5, 5, 9, 9, 5, 9, 5, 9, 5, 8, 5, 7, 5, 5, 7, 5 ],
	[ 5, 5, 5, 5, 5, 5, 5, 5, 9, 5, 5, 5, 5, 5, 7, 9 ],
	[ 5, 5, 9, 9, 5, 5, 5, 5, 5, 7, 5, 5, 5, 7, 9, 9 ],
	[ 9, 7, 9, 5, 5, 9, 8, 5, 5, 8, 5, 7, 9, 7, 7, 5 ]
],
"objects": [
	{
		"x": -1344,
		"y": -416,
		"type": "HAUNTED_TREE"
	}
],
"lastModified": 1730134456070,
"isMultiplayer": true
}