{
"x": 2,
"y": -4,
"biomeType": "HAUNTED",
"tileData": [
	[ 9, 5, 9, 5, 5, 5, 5, 5, 5, 5, 9, 9, 5, 5, 5, 5 ],
	[ 5, 8, 5, 5, 9, 5, 7, 7, 5, 5, 7, 9, 5, 5, 5, 9 ],
	[ 5, 7, 5, 5, 5, 7, 5, 5, 9, 5, 5, 5, 5, 7, 5, 5 ],
	[ 9, 5, 5, 7, 5, 9, 5, 5, 5, 5, 9, 5, 5, 8, 5, 7 ],
	[ 5, 5, 5, 9, 7, 5, 7, 5, 5, 9, 7, 9, 9, 5, 9, 7 ],
	[ 5, 5, 5, 7, 5, 5, 5, 5, 5, 9, 5, 5, 7, 9, 5, 9 ],
	[ 5, 5, 5, 9, 5, 5, 5, 9, 9, 5, 5, 7, 5, 5, 5, 9 ],
	[ 5, 7, 9, 5, 5, 5, 5, 9, 5, 5, 5, 5, 5, 5, 5, 7 ],
	[ 5, 9, 7, 5, 8, 5, 5, 7, 5, 5, 5, 9, 5, 5, 5, 5 ],
	[ 9, 9, 5, 5, 5, 9, 7, 7, 9, 5, 5, 5, 5, 5, 5, 7 ],
	[ 5, 9, 5, 5, 5, 9, 5, 5, 5, 5, 5, 7, 8, 5, 5, 5 ],
	[ 5, 8, 5, 9, 5, 5, 9, 5, 8, 5, 9, 9, 5, 8, 5, 5 ],
	[ 5, 5, 5, 5, 5, 9, 5, 5, 5, 9, 5, 9, 5, 5, 5, 5 ],
	[ 5, 8, 5, 9, 5, 5, 5, 5, 7, 5, 9, 9, 5, 5, 5, 5 ],
	[ 9, 5, 9, 5, 5, 5, 7, 7, 5, 5, 5, 5, 5, 5, 7, 5 ],
	[ 5, 5, 5, 5, 5, 5, 5, 9, 7, 5, 5, 5, 7, 9, 5, 5 ]
],
"objects": [
	{
		"x": 1216,
		"y": -1984,
		"type": "HAUNTED_TREE"
	},
	{
		"x": 1280,
		"y": -1792,
		"type": "HAUNTED_TREE"
	}
],
"lastModified": 1730135519253,
"isMultiplayer": true
}