{
"x": -7,
"y": 2,
"biomeType": "PLAINS",
"tileData": [
	[ 1, 10, 10, 1, 1, 1, 1, 10, 10, 1, 10, 1, 10, 10, 1, 1 ],
	[ 1, 1, 10, 10, 1, 1, 1, 1, 1, 1, 1, 10, 1, 1, 1, 1 ],
	[ 10, 10, 1, 1, 1, 1, 1, 1, 10, 1, 1, 1, 10, 1, 1, 10 ],
	[ 10, 1, 1, 1, 1, 1, 1, 1, 10, 10, 1, 10, 10, 1, 1, 1 ],
	[ 1, 1, 1, 1, 1, 1, 1, 10, 10, 1, 1, 10, 10, 1, 1, 1 ],
	[ 1, 1, 1, 1, 10, 1, 1, 1, 1, 1, 1, 1, 1, 1, 10, 1 ],
	[ 10, 1, 1, 10, 1, 1, 1, 1, 1, 1, 1, 10, 1, 1, 1, 10 ],
	[ 10, 10, 1, 1, 1, 1, 1, 1, 1, 1, 1, 1, 1, 1, 1, 1 ],
	[ 1, 1, 1, 10, 1, 1, 1, 1, 1, 1, 1, 1, 1, 10, 1, 10 ],
	[ 1, 1, 10, 10, 1, 1, 10, 10, 1, 1, 1, 1, 10, 1, 10, 1 ],
	[ 10, 1, 10, 1, 10, 1, 10, 10, 10, 1, 1, 10, 1, 10, 1, 10 ],
	[ 1, 1, 1, 1, 1, 1, 1, 1, 10, 1, 1, 1, 1, 1, 1, 1 ],
	[ 1, 10, 1, 10, 1, 10, 1, 1, 1, 1, 1, 1, 1, 1, 10, 1 ],
	[ 10, 10, 1, 1, 1, 10, 1, 1, 10, 1, 10, 1, 10, 1, 10, 1 ],
	[ 1, 1, 1, 1, 1, 1, 10, 1, 1, 1, 10, 1, 1, 1, 1, 1 ],
	[ 1, 1, 10, 1, 1, 1, 1, 1, 1, 10, 1, 1, 1, 1, 10, 1 ]
],
"objects": [
	{
		"x": -3264,
		"y": 1312,
		"type": "POKEBALL"
	},
	{
		"x": -3552,
		"y": 1280,
		"type": "POKEBALL"
	},
	{
		"x": -3456,
		"y": 1184,
		"type": "POKEBALL"
	},
	{
		"x": -3520,
		"y": 1184,
		"type": "POKEBALL"
	},
	{
		"x": -3552,
		"y": 1504,
		"type": "POKEBALL"
	}
],
"lastModified": 1730134607283,
"isMultiplayer": true
}