{
"x": -7,
"y": 3,
"biomeType": "PLAINS",
"tileData": [
	[ 1, 1, 1, 1, 10, 1, 1, 1, 1, 1, 1, 10, 1, 1, 1, 1 ],
	[ 1, 1, 10, 1, 10, 1, 1, 1, 1, 1, 1, 1, 1, 1, 1, 10 ],
	[ 1, 1, 1, 1, 1, 1, 1, 10, 1, 1, 1, 1, 1, 1, 1, 1 ],
	[ 10, 1, 1, 10, 1, 1, 1, 1, 1, 1, 1, 1, 1, 1, 1, 1 ],
	[ 10, 1, 10, 10, 1, 1, 10, 1, 1, 1, 1, 1, 10, 1, 1, 1 ],
	[ 1, 1, 10, 1, 1, 1, 10, 10, 1, 1, 1, 1, 1, 10, 10, 10 ],
	[ 1, 1, 1, 1, 1, 1, 1, 1, 1, 1, 10, 1, 1, 1, 10, 10 ],
	[ 1, 1, 1, 1, 1, 10, 1, 10, 1, 1, 1, 10, 1, 1, 1, 10 ],
	[ 1, 10, 1, 1, 1, 1, 10, 1, 1, 1, 1, 1, 1, 1, 10, 1 ],
	[ 1, 1, 1, 1, 1, 10, 10, 1, 1, 1, 1, 10, 1, 1, 10, 1 ],
	[ 10, 1, 1, 1, 1, 1, 1, 1, 10, 1, 10, 1, 1, 1, 1, 1 ],
	[ 1, 10, 1, 10, 10, 1, 1, 1, 1, 1, 1, 1, 1, 1, 1, 1 ],
	[ 1, 1, 1, 1, 1, 1, 10, 1, 1, 10, 1, 1, 1, 1, 1, 10 ],
	[ 1, 1, 1, 1, 1, 1, 1, 10, 1, 1, 1, 10, 1, 1, 10, 10 ],
	[ 1, 1, 1, 1, 1, 1, 1, 1, 1, 1, 10, 10, 1, 1, 1, 1 ],
	[ 1, 1, 1, 10, 1, 1, 1, 1, 1, 1, 1, 1, 1, 1, 10, 1 ]
],
"objects": [
	{
		"x": -3136,
		"y": 1696,
		"type": "POKEBALL"
	},
	{
		"x": -3488,
		"y": 1792,
		"type": "POKEBALL"
	},
	{
		"x": -3552,
		"y": 1632,
		"type": "POKEBALL"
	},
	{
		"x": -3488,
		"y": 1600,
		"type": "POKEBALL"
	},
	{
		"x": -3168,
		"y": 1824,
		"type": "POKEBALL"
	},
	{
		"x": -3424,
		"y": 1664,
		"type": "POKEBALL"
	}
],
"lastModified": 1730134607281,
"isMultiplayer": true
}