{
"x": 3,
"y": -3,
"biomeType": "HAUNTED",
"tileData": [
	[ 7, 5, 5, 5, 5, 5, 5, 5, 5, 5, 5, 7, 5, 5, 9, 5 ],
	[ 5, 7, 9, 7, 9, 9, 5, 5, 5, 9, 5, 5, 5, 5, 9, 5 ],
	[ 5, 9, 5, 7, 5, 7, 5, 7, 8, 5, 5, 9, 7, 5, 5, 5 ],
	[ 5, 5, 7, 9, 5, 5, 5, 5, 5, 5, 7, 5, 5, 7, 9, 7 ],
	[ 5, 7, 5, 5, 9, 9, 9, 7, 7, 5, 5, 9, 7, 8, 5, 5 ],
	[ 5, 5, 5, 5, 5, 5, 9, 5, 5, 9, 5, 5, 5, 9, 5, 8 ],
	[ 5, 7, 9, 5, 7, 9, 5, 9, 9, 5, 5, 8, 7, 5, 9, 5 ],
	[ 7, 9, 5, 5, 9, 9, 9, 5, 5, 7, 5, 7, 5, 7, 5, 8 ],
	[ 9, 5, 5, 5, 5, 5, 5, 8, 5, 9, 5, 5, 5, 5, 5, 5 ],
	[ 5, 5, 9, 5, 5, 5, 5, 9, 5, 8, 5, 5, 7, 5, 7, 5 ],
	[ 5, 5, 9, 5, 5, 5, 5, 5, 5, 5, 9, 7, 5, 5, 9, 5 ],
	[ 9, 9, 5, 5, 5, 5, 8, 5, 5, 5, 7, 5, 5, 9, 5, 5 ],
	[ 5, 5, 9, 5, 9, 7, 9, 5, 5, 9, 5, 5, 9, 7, 5, 5 ],
	[ 7, 5, 5, 5, 5, 9, 5, 9, 5, 5, 9, 8, 5, 7, 5, 9 ],
	[ 9, 5, 9, 5, 5, 5, 9, 5, 7, 9, 5, 5, 5, 5, 5, 9 ],
	[ 9, 5, 5, 9, 5, 9, 5, 5, 5, 5, 7, 5, 5, 7, 5, 7 ]
],
"objects": [
	{
		"x": 1824,
		"y": -1184,
		"type": "HAUNTED_TREE"
	}
],
"lastModified": 1730127478219,
"isMultiplayer": true
}