{
"x": -2,
"y": 3,
"biomeType": "PLAINS",
"tileData": [
	[ 1, 1, 1, 1, 10, 1, 1, 1, 10, 1, 1, 1, 1, 1, 1, 1 ],
	[ 1, 1, 1, 1, 1, 1, 1, 1, 1, 1, 1, 10, 1, 10, 1, 1 ],
	[ 1, 1, 1, 1, 1, 1, 10, 1, 1, 10, 1, 1, 1, 1, 1, 10 ],
	[ 1, 10, 1, 1, 1, 10, 1, 1, 10, 10, 1, 1, 10, 1, 1, 1 ],
	[ 1, 1, 1, 10, 1, 10, 1, 10, 1, 1, 1, 10, 1, 1, 1, 10 ],
	[ 1, 1, 1, 10, 1, 1, 1, 1, 1, 1, 1, 10, 1, 1, 10, 1 ],
	[ 1, 10, 1, 1, 1, 1, 1, 1, 1, 10, 10, 1, 1, 1, 10, 1 ],
	[ 1, 1, 1, 1, 1, 1, 1, 10, 1, 1, 1, 1, 10, 1, 1, 10 ],
	[ 1, 1, 1, 1, 1, 1, 10, 1, 1, 10, 10, 1, 1, 1, 10, 1 ],
	[ 1, 1, 1, 1, 1, 10, 1, 10, 1, 1, 1, 1, 10, 1, 1, 1 ],
	[ 10, 1, 1, 1, 1, 10, 1, 1, 1, 10, 1, 1, 1, 1, 1, 1 ],
	[ 1, 1, 1, 1, 1, 1, 1, 1, 1, 1, 10, 1, 10, 1, 1, 1 ],
	[ 1, 1, 10, 1, 1, 1, 1, 1, 1, 10, 1, 1, 1, 1, 1, 1 ],
	[ 1, 1, 1, 10, 1, 1, 1, 1, 10, 1, 1, 1, 1, 10, 1, 1 ],
	[ 1, 1, 1, 1, 10, 1, 1, 1, 1, 10, 1, 1, 1, 1, 1, 1 ],
	[ 1, 1, 1, 1, 1, 1, 1, 1, 1, 1, 1, 1, 1, 1, 10, 1 ]
],
"lastModified": 1730134599774,
"isMultiplayer": true
}