{
"x": -12,
"y": -3,
"biomeType": "HAUNTED",
"tileData": [
	[ 7, 5, 5, 5, 5, 5, 5, 5, 5, 9, 7, 5, 5, 5, 9, 5 ],
	[ 5, 9, 5, 5, 5, 5, 5, 5, 8, 9, 5, 5, 5, 5, 5, 9 ],
	[ 5, 5, 9, 9, 5, 5, 7, 9, 5, 5, 7, 9, 7, 5, 5, 9 ],
	[ 7, 5, 7, 5, 5, 7, 8, 9, 5, 5, 5, 9, 7, 5, 5, 7 ],
	[ 9, 5, 7, 5, 5, 7, 9, 9, 5, 5, 8, 9, 9, 7, 7, 7 ],
	[ 5, 7, 5, 5, 9, 5, 5, 7, 5, 5, 7, 5, 7, 9, 5, 5 ],
	[ 9, 5, 8, 5, 7, 5, 5, 5, 5, 9, 7, 7, 7, 7, 7, 9 ],
	[ 7, 9, 5, 5, 5, 9, 5, 7, 5, 5, 9, 7, 9, 5, 5, 5 ],
	[ 5, 5, 7, 5, 9, 9, 5, 5, 5, 9, 9, 7, 5, 5, 5, 8 ],
	[ 8, 5, 5, 5, 5, 5, 5, 9, 9, 5, 5, 5, 5, 5, 5, 5 ],
	[ 9, 5, 8, 7, 5, 5, 5, 5, 9, 5, 8, 5, 5, 5, 5, 5 ],
	[ 5, 5, 9, 9, 5, 5, 9, 5, 5, 8, 5, 9, 7, 7, 5, 5 ],
	[ 5, 5, 5, 9, 9, 5, 9, 5, 9, 5, 5, 9, 5, 8, 7, 5 ],
	[ 9, 5, 9, 9, 5, 7, 7, 5, 5, 9, 9, 5, 5, 5, 5, 7 ],
	[ 5, 9, 5, 5, 5, 9, 5, 5, 9, 5, 5, 9, 5, 8, 5, 5 ],
	[ 5, 5, 5, 5, 5, 5, 7, 5, 5, 9, 5, 5, 7, 5, 5, 5 ]
],
"objects": [
	{
		"x": -5952,
		"y": -1312,
		"type": "HAUNTED_TREE"
	}
],
"lastModified": 1730134599778,
"isMultiplayer": true
}