{
"y": -2,
"biomeType": "HAUNTED",
"tileData": [
	[ 7, 9, 5, 5, 9, 5, 5, 5, 5, 9, 5, 9, 5, 5, 5, 9 ],
	[ 9, 7, 9, 7, 7, 7, 5, 5, 8, 9, 9, 5, 5, 5, 9, 5 ],
	[ 5, 9, 5, 5, 9, 5, 5, 5, 5, 5, 9, 9, 5, 5, 5, 7 ],
	[ 5, 8, 5, 7, 9, 7, 5, 7, 9, 7, 7, 5, 5, 9, 5, 5 ],
	[ 5, 9, 7, 9, 5, 5, 5, 5, 7, 9, 5, 5, 8, 5, 9, 5 ],
	[ 9, 5, 5, 5, 5, 5, 5, 8, 7, 7, 5, 5, 5, 5, 5, 5 ],
	[ 5, 7, 5, 5, 7, 5, 5, 7, 9, 5, 5, 9, 5, 5, 9, 7 ],
	[ 9, 5, 7, 5, 5, 5, 5, 5, 7, 5, 5, 5, 5, 5, 7, 9 ],
	[ 9, 7, 5, 7, 5, 5, 5, 5, 5, 9, 9, 5, 7, 9, 7, 7 ],
	[ 7, 5, 5, 9, 9, 5, 5, 7, 9, 5, 9, 9, 5, 5, 5, 5 ],
	[ 5, 9, 5, 5, 5, 5, 5, 5, 5, 5, 5, 9, 5, 5, 5, 5 ],
	[ 5, 5, 8, 5, 9, 7, 5, 7, 5, 5, 7, 5, 7, 5, 5, 5 ],
	[ 9, 5, 5, 5, 9, 5, 7, 9, 5, 5, 9, 7, 5, 5, 5, 5 ],
	[ 5, 9, 5, 5, 5, 9, 5, 5, 7, 5, 9, 5, 9, 8, 5, 9 ],
	[ 5, 7, 5, 5, 5, 9, 5, 5, 5, 9, 8, 5, 5, 9, 5, 5 ],
	[ 9, 9, 5, 9, 9, 7, 5, 5, 5, 5, 9, 7, 5, 7, 5, 5 ]
],
"objects": [
	{
		"x": 64,
		"y": -864,
		"type": "HAUNTED_TREE"
	}
],
"lastModified": 1730134438759,
"isMultiplayer": true
}