{
"x": -2,
"y": 2,
"biomeType": "PLAINS",
"tileData": [
	[ 1, 1, 1, 1, 1, 1, 1, 10, 1, 1, 10, 1, 1, 1, 10, 1 ],
	[ 1, 1, 1, 1, 1, 10, 10, 10, 1, 1, 1, 1, 1, 1, 1, 10 ],
	[ 1, 1, 1, 1, 10, 1, 10, 1, 1, 1, 1, 1, 1, 1, 10, 1 ],
	[ 1, 1, 1, 1, 1, 1, 1, 1, 1, 10, 1, 1, 1, 10, 1, 1 ],
	[ 1, 1, 10, 1, 10, 1, 1, 1, 10, 1, 10, 1, 1, 1, 1, 10 ],
	[ 1, 1, 1, 10, 10, 1, 1, 1, 1, 1, 1, 1, 1, 10, 10, 1 ],
	[ 10, 10, 10, 1, 1, 1, 1, 1, 1, 1, 1, 1, 1, 1, 10, 1 ],
	[ 1, 10, 1, 1, 1, 1, 1, 1, 1, 1, 1, 1, 1, 1, 1, 10 ],
	[ 10, 10, 1, 1, 1, 1, 10, 1, 1, 1, 1, 1, 1, 1, 1, 10 ],
	[ 1, 10, 1, 1, 10, 1, 1, 1, 1, 10, 1, 1, 1, 1, 10, 1 ],
	[ 1, 1, 1, 1, 1, 1, 1, 1, 10, 10, 1, 1, 1, 1, 1, 1 ],
	[ 1, 1, 1, 10, 1, 10, 1, 1, 1, 1, 1, 1, 1, 1, 1, 1 ],
	[ 1, 1, 10, 1, 1, 10, 1, 1, 1, 1, 1, 10, 10, 1, 1, 10 ],
	[ 1, 1, 1, 1, 1, 1, 1, 1, 1, 10, 1, 1, 1, 10, 1, 1 ],
	[ 1, 10, 1, 1, 1, 1, 10, 1, 1, 1, 1, 10, 10, 1, 1, 1 ],
	[ 1, 10, 1, 1, 1, 1, 1, 1, 10, 1, 10, 1, 1, 1, 1, 1 ]
],
"objects": [
	{
		"x": -704,
		"y": 1216,
		"type": "TREE"
	}
],
"lastModified": 1730127108178,
"isMultiplayer": true
}