{
"x": -3,
"y": 3,
"biomeType": "PLAINS",
"tileData": [
	[ 1, 1, 1, 10, 1, 1, 1, 1, 1, 10, 1, 1, 1, 1, 1, 10 ],
	[ 10, 1, 10, 10, 1, 1, 10, 1, 1, 1, 1, 1, 1, 1, 1, 10 ],
	[ 1, 1, 10, 1, 1, 1, 1, 1, 1, 1, 1, 1, 1, 1, 1, 10 ],
	[ 1, 1, 1, 1, 1, 1, 1, 10, 1, 1, 1, 1, 1, 1, 10, 10 ],
	[ 1, 1, 10, 1, 10, 1, 1, 1, 1, 10, 1, 1, 1, 1, 1, 1 ],
	[ 1, 1, 1, 1, 1, 1, 1, 1, 10, 1, 10, 10, 10, 10, 1, 1 ],
	[ 10, 1, 1, 1, 1, 1, 1, 1, 1, 1, 1, 1, 1, 1, 1, 10 ],
	[ 1, 10, 1, 1, 1, 1, 10, 10, 1, 1, 1, 10, 10, 1, 1, 1 ],
	[ 1, 1, 1, 1, 1, 1, 10, 1, 1, 1, 1, 1, 10, 1, 1, 1 ],
	[ 1, 1, 1, 1, 1, 1, 1, 1, 1, 1, 10, 10, 1, 1, 10, 1 ],
	[ 10, 1, 1, 1, 1, 1, 1, 1, 1, 1, 1, 10, 1, 1, 10, 1 ],
	[ 1, 1, 1, 1, 1, 1, 1, 10, 1, 10, 1, 1, 1, 1, 1, 10 ],
	[ 1, 1, 1, 1, 1, 1, 10, 1, 1, 10, 10, 1, 1, 1, 1, 1 ],
	[ 10, 1, 1, 1, 1, 1, 1, 1, 10, 1, 1, 1, 1, 1, 1, 1 ],
	[ 1, 1, 1, 1, 10, 1, 1, 1, 10, 1, 1, 10, 10, 10, 10, 1 ],
	[ 10, 1, 1, 1, 1, 10, 1, 1, 1, 10, 1, 1, 1, 1, 1, 10 ]
],
"objects": [
	{
		"x": -1312,
		"y": 1728,
		"type": "TREE"
	}
],
"lastModified": 1730134596106,
"isMultiplayer": true
}