{
"x": -15,
"y": 1,
"biomeType": "HAUNTED",
"tileData": [
	[ 5, 7, 5, 5, 8, 7, 5, 5, 7, 5, 5, 8, 5, 5, 5, 5 ],
	[ 9, 5, 5, 7, 5, 8, 7, 5, 9, 5, 5, 5, 5, 5, 5, 5 ],
	[ 9, 9, 5, 5, 8, 5, 5, 9, 5, 5, 5, 5, 5, 5, 5, 5 ],
	[ 7, 5, 9, 5, 5, 5, 5, 9, 5, 7, 7, 9, 5, 5, 5, 5 ],
	[ 5, 5, 7, 9, 9, 5, 7, 5, 5, 7, 5, 9, 5, 9, 5, 5 ],
	[ 5, 5, 5, 5, 5, 9, 9, 5, 5, 7, 5, 9, 9, 5, 5, 9 ],
	[ 5, 7, 5, 7, 9, 5, 5, 5, 7, 7, 5, 5, 5, 7, 5, 9 ],
	[ 5, 5, 5, 5, 5, 5, 9, 9, 9, 8, 5, 5, 7, 7, 5, 5 ],
	[ 5, 5, 5, 5, 5, 5, 5, 5, 9, 5, 8, 5, 5, 9, 5, 5 ],
	[ 7, 5, 8, 5, 5, 5, 9, 5, 5, 5, 7, 5, 7, 5, 5, 5 ],
	[ 5, 5, 9, 9, 9, 9, 7, 7, 5, 9, 5, 8, 5, 5, 9, 5 ],
	[ 5, 5, 5, 5, 5, 7, 5, 5, 5, 9, 5, 5, 5, 5, 5, 5 ],
	[ 9, 9, 5, 5, 7, 5, 5, 9, 5, 5, 8, 7, 5, 8, 5, 9 ],
	[ 9, 5, 5, 9, 5, 5, 5, 5, 7, 5, 5, 5, 5, 5, 9, 9 ],
	[ 9, 5, 5, 8, 9, 5, 5, 5, 5, 5, 9, 9, 7, 5, 7, 5 ],
	[ 5, 9, 7, 5, 9, 5, 5, 5, 5, 5, 5, 8, 9, 5, 5, 5 ]
],
"objects": [
	{
		"x": -7424,
		"y": 864,
		"type": "HAUNTED_TREE"
	},
	{
		"x": -7360,
		"y": 832,
		"type": "HAUNTED_TREE"
	}
],
"lastModified": 1730134515322,
"isMultiplayer": true
}