{
"x": -14,
"y": 1,
"biomeType": "HAUNTED",
"tileData": [
	[ 5, 5, 9, 5, 7, 5, 5, 5, 9, 9, 5, 5, 5, 5, 5, 5 ],
	[ 7, 5, 5, 7, 5, 5, 5, 5, 5, 5, 9, 9, 5, 5, 5, 9 ],
	[ 5, 5, 5, 9, 7, 5, 7, 5, 5, 5, 5, 5, 5, 9, 8, 5 ],
	[ 5, 5, 9, 5, 5, 5, 5, 7, 9, 5, 7, 5, 5, 8, 5, 5 ],
	[ 5, 5, 8, 7, 9, 5, 5, 5, 5, 5, 5, 9, 5, 5, 9, 5 ],
	[ 5, 7, 5, 5, 5, 5, 5, 9, 5, 7, 5, 9, 9, 5, 5, 5 ],
	[ 5, 5, 5, 9, 7, 5, 5, 5, 5, 5, 7, 5, 9, 5, 7, 5 ],
	[ 5, 9, 5, 9, 7, 9, 5, 5, 5, 5, 5, 5, 7, 5, 9, 5 ],
	[ 5, 7, 7, 7, 9, 5, 5, 5, 5, 5, 9, 5, 7, 5, 9, 5 ],
	[ 5, 7, 5, 5, 5, 5, 5, 7, 5, 7, 5, 5, 9, 5, 5, 5 ],
	[ 9, 5, 5, 7, 9, 8, 5, 5, 5, 7, 5, 5, 5, 5, 5, 5 ],
	[ 5, 7, 5, 5, 5, 5, 5, 5, 5, 5, 5, 5, 5, 5, 7, 5 ],
	[ 7, 7, 5, 8, 9, 5, 5, 5, 5, 5, 8, 5, 5, 9, 5, 5 ],
	[ 5, 7, 5, 5, 9, 8, 9, 5, 5, 9, 5, 5, 9, 7, 5, 5 ],
	[ 9, 7, 5, 5, 9, 7, 5, 5, 5, 5, 8, 5, 5, 5, 5, 5 ],
	[ 5, 9, 5, 9, 5, 7, 5, 5, 5, 5, 9, 8, 9, 7, 8, 5 ]
],
"objects": [
	{
		"x": -6976,
		"y": 736,
		"type": "HAUNTED_TREE"
	}
],
"lastModified": 1730134518358,
"isMultiplayer": true
}