{
"x": -9,
"y": 2,
"biomeType": "PLAINS",
"tileData": [
	[ 1, 1, 1, 1, 10, 1, 10, 1, 1, 10, 1, 1, 10, 1, 1, 1 ],
	[ 10, 1, 1, 10, 10, 10, 1, 1, 10, 1, 1, 10, 10, 1, 1, 1 ],
	[ 1, 10, 10, 10, 1, 1, 10, 1, 1, 1, 1, 10, 1, 1, 1, 1 ],
	[ 10, 1, 10, 1, 1, 1, 1, 1, 1, 10, 1, 1, 1, 1, 1, 1 ],
	[ 1, 1, 1, 10, 1, 10, 10, 1, 1, 1, 1, 1, 1, 1, 1, 1 ],
	[ 1, 1, 1, 1, 1, 1, 10, 1, 1, 1, 1, 1, 1, 10, 10, 1 ],
	[ 1, 1, 1, 1, 10, 1, 1, 1, 10, 10, 10, 1, 1, 1, 1, 1 ],
	[ 1, 10, 10, 1, 1, 1, 1, 10, 1, 1, 1, 10, 1, 1, 10, 10 ],
	[ 1, 10, 10, 1, 10, 10, 1, 1, 1, 1, 1, 10, 1, 10, 1, 1 ],
	[ 1, 1, 1, 1, 1, 1, 1, 1, 1, 1, 1, 1, 10, 1, 1, 10 ],
	[ 1, 1, 1, 1, 1, 1, 10, 1, 1, 1, 1, 1, 10, 1, 1, 1 ],
	[ 10, 10, 10, 10, 10, 1, 10, 1, 1, 1, 10, 1, 1, 1, 1, 1 ],
	[ 1, 1, 10, 1, 1, 1, 1, 1, 1, 1, 1, 1, 10, 10, 1, 1 ],
	[ 1, 1, 1, 10, 1, 1, 1, 1, 1, 1, 10, 1, 1, 1, 10, 1 ],
	[ 1, 10, 1, 1, 1, 1, 10, 10, 1, 10, 1, 1, 1, 1, 10, 1 ],
	[ 1, 1, 10, 1, 1, 10, 1, 10, 1, 1, 1, 1, 1, 10, 10, 1 ]
],
"objects": [
	{
		"x": -4288,
		"y": 1088,
		"type": "TREE"
	},
	{
		"x": -4448,
		"y": 1408,
		"type": "POKEBALL"
	},
	{
		"x": -4448,
		"y": 1056,
		"type": "POKEBALL"
	},
	{
		"x": -4224,
		"y": 1248,
		"type": "POKEBALL"
	},
	{
		"x": -4352,
		"y": 1024,
		"type": "POKEBALL"
	},
	{
		"x": -4608,
		"y": 1376,
		"type": "POKEBALL"
	},
	{
		"x": -4224,
		"y": 1376,
		"type": "POKEBALL"
	}
],
"lastModified": 1730134602331,
"isMultiplayer": true
}