{
"x": -1,
"y": 1,
"biomeType": "HAUNTED",
"tileData": [
	[ 5, 9, 5, 5, 5, 5, 7, 5, 5, 5, 5, 5, 5, 5, 7, 9 ],
	[ 5, 5, 5, 9, 5, 5, 9, 5, 7, 5, 7, 7, 8, 5, 7, 5 ],
	[ 5, 8, 5, 7, 9, 9, 9, 5, 5, 5, 5, 5, 5, 5, 5, 8 ],
	[ 9, 9, 5, 5, 5, 5, 7, 5, 9, 9, 7, 5, 9, 5, 5, 5 ],
	[ 9, 7, 5, 9, 5, 9, 7, 9, 9, 7, 5, 5, 5, 9, 9, 7 ],
	[ 5, 5, 8, 5, 5, 9, 5, 9, 9, 5, 9, 5, 5, 5, 5, 5 ],
	[ 5, 9, 7, 7, 7, 9, 5, 5, 5, 9, 7, 9, 5, 7, 7, 9 ],
	[ 5, 5, 5, 7, 5, 5, 5, 5, 5, 8, 5, 9, 8, 5, 5, 5 ],
	[ 5, 5, 5, 5, 5, 8, 8, 7, 5, 8, 8, 5, 8, 5, 5, 9 ],
	[ 8, 9, 5, 5, 9, 7, 5, 5, 9, 7, 8, 7, 9, 5, 7, 7 ],
	[ 5, 5, 5, 5, 9, 5, 5, 5, 5, 5, 9, 5, 7, 9, 7, 9 ],
	[ 5, 9, 7, 5, 9, 5, 5, 5, 9, 5, 7, 5, 5, 5, 5, 5 ],
	[ 5, 5, 9, 5, 5, 5, 5, 5, 5, 5, 5, 5, 7, 5, 5, 5 ],
	[ 5, 5, 5, 5, 5, 5, 5, 5, 9, 5, 5, 5, 5, 5, 5, 5 ],
	[ 5, 5, 5, 9, 8, 5, 5, 7, 5, 5, 5, 5, 7, 7, 5, 5 ],
	[ 5, 9, 7, 5, 9, 5, 5, 5, 7, 5, 5, 5, 9, 9, 5, 7 ]
],
"objects": [
	{
		"x": -416,
		"y": 832,
		"type": "HAUNTED_TREE"
	},
	{
		"x": -192,
		"y": 608,
		"type": "HAUNTED_TREE"
	}
],
"lastModified": 1730127108189,
"isMultiplayer": true
}