{
"x": 1,
"y": 2,
"biomeType": "PLAINS",
"tileData": [
	[ 1, 1, 1, 1, 1, 1, 1, 1, 1, 1, 1, 1, 10, 1, 1, 1 ],
	[ 1, 1, 1, 1, 10, 1, 1, 1, 1, 10, 10, 1, 1, 1, 1, 10 ],
	[ 1, 1, 1, 10, 1, 10, 1, 1, 10, 1, 1, 1, 1, 1, 1, 1 ],
	[ 1, 1, 10, 1, 10, 1, 1, 1, 1, 1, 1, 10, 1, 1, 1, 1 ],
	[ 10, 1, 10, 1, 1, 10, 1, 1, 1, 10, 1, 1, 1, 10, 1, 1 ],
	[ 1, 1, 1, 10, 1, 1, 1, 1, 1, 1, 1, 1, 10, 1, 10, 1 ],
	[ 1, 1, 1, 10, 1, 10, 10, 1, 1, 10, 1, 1, 1, 1, 1, 1 ],
	[ 10, 10, 1, 10, 1, 1, 10, 1, 1, 1, 10, 10, 1, 10, 1, 1 ],
	[ 1, 1, 1, 10, 1, 1, 1, 1, 1, 1, 1, 1, 1, 1, 1, 1 ],
	[ 1, 1, 10, 1, 1, 1, 1, 10, 10, 1, 1, 1, 1, 1, 1, 1 ],
	[ 10, 10, 1, 1, 1, 1, 1, 10, 10, 1, 1, 1, 1, 1, 1, 10 ],
	[ 1, 1, 1, 1, 1, 1, 1, 1, 1, 1, 1, 10, 1, 1, 1, 1 ],
	[ 10, 1, 10, 1, 1, 1, 1, 1, 1, 1, 10, 1, 10, 1, 1, 1 ],
	[ 1, 1, 1, 1, 1, 10, 10, 1, 1, 1, 1, 1, 1, 1, 1, 10 ],
	[ 1, 10, 1, 1, 1, 10, 1, 1, 1, 1, 1, 1, 1, 1, 1, 10 ],
	[ 1, 1, 1, 1, 1, 1, 1, 1, 10, 1, 1, 1, 10, 1, 1, 1 ]
],
"objects": [
	{
		"x": 608,
		"y": 1120,
		"type": "TREE"
	},
	{
		"x": 768,
		"y": 1152,
		"type": "TREE"
	}
],
"lastModified": 1730127108209,
"isMultiplayer": true
}