{
"x": -3,
"y": -37,
"biomeType": "SNOW",
"tileData": [
	[ 13, 10, 14, 140, 14, 216, 203, 216, 203, 203, 203, 203, 203, 203, 203, 201 ],
	[ 13, 1, 14, 216, 203, 204, 216, 204, 204, 204, 204, 204, 204, 204, 201, 201 ],
	[ 1, 216, 203, 204, 204, 216, 204, 204, 204, 216, 200, 204, 204, 204, 202, 201 ],
	[ 216, 204, 204, 216, 203, 204, 204, 204, 216, 204, 204, 200, 204, 201, 204, 201 ],
	[ 216, 216, 203, 204, 204, 204, 204, 204, 208, 204, 204, 202, 204, 202, 204, 210 ],
	[ 216, 204, 204, 204, 204, 204, 204, 204, 204, 208, 202, 204, 201, 204, 201, 52 ],
	[ 216, 204, 204, 204, 204, 204, 204, 204, 204, 204, 204, 204, 202, 204, 210, 4 ],
	[ 208, 205, 204, 204, 204, 204, 204, 204, 204, 205, 205, 202, 204, 201, 4, 51 ],
	[ 216, 204, 208, 204, 204, 204, 204, 204, 202, 204, 204, 204, 204, 210, 51, 4 ],
	[ 216, 204, 204, 208, 205, 205, 205, 202, 204, 204, 204, 204, 201, 51, 4, 6 ],
	[ 216, 204, 204, 204, 204, 204, 204, 204, 204, 204, 204, 205, 210, 4, 51, 6 ],
	[ 216, 204, 204, 204, 204, 204, 204, 204, 204, 204, 210, 51, 4, 4, 6, 4 ],
	[ 211, 205, 205, 205, 205, 205, 205, 205, 205, 210, 4, 6, 4, 4, 52, 4 ],
	[ 4, 4, 51, 4, 4, 6, 4, 6, 4, 6, 4, 4, 4, 4, 4, 4 ],
	[ 4, 6, 4, 4, 4, 51, 4, 4, 4, 51, 4, 4, 4, 4, 4, 4 ],
	[ 4, 4, 4, 6, 4, 6, 4, 4, 4, 4, 4, 4, 4, 6, 4, 4 ]
],
"objects": [
	{
		"class": "io.github.pokemeetup.system.gameplay.overworld.World$WorldObjectData",
		"x": -1504,
		"y": -18880,
		"type": "RAIN_TREE"
	},
	{
		"class": "io.github.pokemeetup.system.gameplay.overworld.World$WorldObjectData",
		"x": -1472,
		"y": -18944,
		"type": "POKEBALL"
	}
],
"blocks": [],
"lastModified": 0,
"isMultiplayer": false
}