{
"x": -1,
"y": -37,
"biomeType": "SNOW",
"tileData": [
	[ 51, 4, 4, 216, 216, 203, 203, 203, 203, 203, 203, 200, 203, 203, 203, 209 ],
	[ 4, 4, 216, 204, 216, 204, 204, 204, 204, 204, 204, 204, 203, 203, 200, 201 ],
	[ 4, 216, 204, 204, 216, 204, 204, 216, 203, 203, 200, 204, 204, 204, 204, 200 ],
	[ 4, 211, 204, 204, 216, 204, 216, 204, 204, 204, 204, 200, 204, 204, 204, 201 ],
	[ 6, 4, 216, 204, 216, 204, 216, 204, 204, 204, 204, 201, 204, 204, 204, 201 ],
	[ 51, 51, 216, 204, 216, 204, 216, 204, 204, 204, 204, 201, 204, 204, 204, 202 ],
	[ 4, 6, 211, 204, 216, 204, 208, 204, 204, 204, 204, 202, 204, 204, 202, 201 ],
	[ 4, 4, 4, 235, 208, 204, 204, 208, 204, 204, 202, 204, 204, 202, 204, 201 ],
	[ 4, 4, 4, 211, 204, 208, 204, 204, 208, 202, 204, 204, 202, 204, 204, 201 ],
	[ 4, 4, 51, 4, 211, 204, 208, 205, 204, 204, 204, 202, 204, 204, 204, 201 ],
	[ 4, 6, 52, 4, 4, 211, 205, 204, 208, 205, 202, 204, 204, 204, 204, 201 ],
	[ 6, 4, 51, 52, 4, 4, 4, 211, 235, 204, 204, 204, 204, 204, 204, 210 ],
	[ 4, 51, 51, 4, 4, 4, 4, 4, 4, 211, 204, 204, 204, 204, 210, 14 ],
	[ 51, 4, 4, 4, 4, 4, 4, 4, 4, 4, 211, 205, 205, 210, 14, 14 ],
	[ 4, 4, 4, 4, 51, 4, 4, 4, 14, 13, 1, 1, 13, 13, 14, 13 ],
	[ 4, 4, 4, 4, 51, 4, 14, 14, 14, 10, 140, 20, 13, 13, 14, 13 ]
],
"objects": [
	{
		"class": "io.github.pokemeetup.system.gameplay.overworld.World$WorldObjectData",
		"x": -64,
		"y": -18944,
		"type": "SNOW_TREE"
	},
	{
		"class": "io.github.pokemeetup.system.gameplay.overworld.World$WorldObjectData",
		"x": -96,
		"y": -18752,
		"type": "SNOW_TREE"
	},
	{
		"class": "io.github.pokemeetup.system.gameplay.overworld.World$WorldObjectData",
		"x": -64,
		"y": -18624,
		"type": "POKEBALL"
	}
],
"blocks": [],
"lastModified": 0,
"isMultiplayer": false
}