{
"x": -3,
"y": 0,
"biomeType": "SNOW",
"tileData": [
	[ 4, 4, 6, 4, 4, 4, 4, 4, 4, 4, 1, 10, 1, 1, 1, 1 ],
	[ 4, 4, 4, 4, 4, 4, 4, 51, 4, 4, 4, 4, 4, 4, 51, 1 ],
	[ 52, 4, 6, 51, 4, 201, 4, 51, 4, 6, 4, 6, 4, 4, 4, 6 ],
	[ 4, 51, 206, 203, 203, 204, 203, 203, 200, 4, 4, 4, 6, 4, 4, 4 ],
	[ 51, 4, 207, 204, 204, 204, 204, 204, 204, 203, 200, 6, 4, 4, 6, 6 ],
	[ 4, 206, 204, 204, 204, 204, 204, 204, 204, 204, 204, 203, 200, 6, 4, 52 ],
	[ 4, 207, 204, 204, 204, 204, 204, 204, 204, 204, 204, 204, 204, 203, 203, 200 ],
	[ 4, 207, 204, 204, 204, 204, 204, 204, 204, 204, 204, 204, 204, 204, 204, 201 ],
	[ 4, 207, 204, 204, 204, 204, 204, 204, 204, 204, 204, 204, 204, 204, 204, 201 ],
	[ 51, 208, 204, 204, 204, 204, 204, 204, 204, 206, 203, 200, 204, 204, 204, 201 ],
	[ 51, 4, 207, 204, 204, 204, 204, 204, 206, 204, 204, 204, 200, 204, 204, 201 ],
	[ 6, 4, 208, 204, 204, 204, 204, 204, 208, 204, 204, 204, 202, 204, 204, 201 ],
	[ 6, 4, 4, 208, 204, 204, 204, 204, 204, 208, 205, 202, 204, 204, 204, 201 ],
	[ 6, 52, 4, 4, 208, 204, 204, 204, 204, 204, 204, 204, 204, 204, 204, 201 ],
	[ 4, 4, 4, 4, 6, 208, 204, 204, 204, 204, 204, 204, 204, 204, 204, 201 ],
	[ 4, 4, 4, 51, 4, 4, 208, 205, 205, 205, 205, 205, 205, 205, 205, 202 ]
],
"objects": [
	{
		"class": "io.github.pokemeetup.system.gameplay.overworld.World$WorldObjectData",
		"x": -1472,
		"y": 96,
		"type": "SNOW_TREE"
	},
	{
		"class": "io.github.pokemeetup.system.gameplay.overworld.World$WorldObjectData",
		"x": -1472,
		"y": 256,
		"type": "SNOW_TREE"
	},
	{
		"class": "io.github.pokemeetup.system.gameplay.overworld.World$WorldObjectData",
		"x": -1088,
		"type": "SNOW_TREE"
	}
],
"blocks": [],
"lastModified": 0,
"isMultiplayer": false
}