{
"x": -2,
"y": 0,
"biomeType": "HAUNTED",
"tileData": [
	[ 4, 4, 4, 4, 52, 4, 4, 5, 5, 5, 7, 5, 5, 7, 5, 5 ],
	[ 51, 4, 51, 6, 4, 7, 5, 5, 1, 9, 5, 5, 8, 5, 7, 5 ],
	[ 51, 52, 4, 4, 8, 5, 5, 1, 5, 5, 5, 7, 5, 5, 5, 7 ],
	[ 4, 4, 4, 9, 5, 5, 1, 7, 5, 5, 8, 5, 5, 5, 9, 5 ],
	[ 4, 5, 8, 8, 7, 5, 5, 5, 7, 7, 5, 7, 5, 5, 5, 5 ],
	[ 5, 7, 7, 5, 5, 9, 5, 5, 5, 5, 9, 9, 7, 5, 5, 7 ],
	[ 1, 5, 5, 5, 5, 5, 5, 7, 8, 7, 8, 9, 5, 5, 8, 7 ],
	[ 8, 5, 1, 5, 5, 7, 7, 5, 5, 5, 7, 5, 7, 1, 10, 5 ],
	[ 5, 7, 7, 8, 5, 5, 5, 8, 7, 9, 5, 7, 5, 24, 5, 1 ],
	[ 5, 5, 5, 5, 7, 9, 5, 9, 7, 5, 5, 5, 5, 5, 5, 5 ],
	[ 7, 5, 5, 7, 5, 7, 1, 7, 5, 7, 5, 5, 7, 7, 1, 1 ],
	[ 5, 7, 8, 5, 7, 5, 7, 5, 5, 7, 7, 5, 1, 10, 1, 10 ],
	[ 5, 5, 7, 5, 1, 5, 5, 7, 5, 5, 1, 24, 1, 1, 10, 1 ],
	[ 5, 1, 7, 7, 9, 5, 5, 8, 1, 10, 10, 10, 1, 1, 24, 10 ],
	[ 5, 7, 5, 1, 5, 5, 1, 24, 10, 10, 10, 1, 1, 1, 10, 1 ],
	[ 5, 5, 10, 5, 1, 10, 10, 1, 1, 10, 10, 1, 1, 10, 1, 1 ]
],
"objects": [
	{
		"class": "io.github.pokemeetup.system.gameplay.overworld.World$WorldObjectData",
		"x": -960,
		"y": 96,
		"type": "SNOW_TREE"
	},
	{
		"class": "io.github.pokemeetup.system.gameplay.overworld.World$WorldObjectData",
		"x": -928,
		"y": 192,
		"type": "POKEBALL"
	}
],
"blocks": [],
"lastModified": 0,
"isMultiplayer": false
}