{
"x": -2,
"y": -1,
"biomeType": "SNOW",
"tileData": [
	[ 4, 51, 4, 4, 4, 216, 209, 4, 51, 4, 6, 6, 4, 52, 4, 51 ],
	[ 51, 4, 4, 216, 203, 204, 204, 203, 209, 4, 4, 51, 4, 4, 51, 4 ],
	[ 4, 4, 216, 204, 204, 204, 204, 204, 204, 209, 4, 4, 4, 51, 4, 4 ],
	[ 4, 6, 216, 204, 204, 204, 204, 204, 204, 204, 209, 4, 4, 4, 4, 6 ],
	[ 4, 216, 204, 204, 204, 204, 204, 204, 204, 204, 204, 209, 4, 4, 4, 51 ],
	[ 4, 216, 204, 204, 204, 204, 204, 204, 204, 204, 204, 204, 209, 6, 4, 5 ],
	[ 4, 216, 204, 204, 204, 204, 204, 204, 204, 204, 204, 204, 204, 201, 5, 5 ],
	[ 207, 204, 204, 204, 204, 204, 204, 204, 204, 204, 204, 204, 210, 5, 7, 7 ],
	[ 4, 211, 204, 204, 204, 204, 204, 204, 204, 204, 204, 210, 5, 5, 7, 5 ],
	[ 51, 4, 211, 204, 204, 204, 204, 204, 204, 204, 210, 5, 5, 5, 9, 1 ],
	[ 4, 4, 6, 211, 205, 205, 205, 205, 205, 210, 5, 5, 7, 7, 7, 7 ],
	[ 10, 5, 5, 7, 235, 10, 5, 7, 5, 5, 5, 5, 5, 5, 5, 5 ],
	[ 5, 7, 5, 9, 7, 5, 5, 5, 7, 5, 5, 7, 9, 8, 5, 7 ],
	[ 5, 5, 7, 5, 5, 5, 7, 5, 5, 5, 5, 5, 8, 5, 5, 5 ],
	[ 5, 9, 8, 5, 7, 5, 7, 5, 1, 5, 5, 5, 7, 5, 216, 209 ],
	[ 5, 5, 1, 5, 7, 5, 5, 7, 10, 7, 7, 5, 5, 207, 205, 210 ]
],
"objects": [
	{
		"class": "io.github.pokemeetup.system.gameplay.overworld.World$WorldObjectData",
		"x": -960,
		"y": -192,
		"type": "SNOW_TREE"
	},
	{
		"class": "io.github.pokemeetup.system.gameplay.overworld.World$WorldObjectData",
		"x": -576,
		"y": -256,
		"type": "POKEBALL"
	}
],
"blocks": [],
"lastModified": 0,
"isMultiplayer": false
}