{
"x": -2,
"y": -38,
"biomeType": "SNOW",
"tileData": [
	[ 216, 203, 203, 203, 203, 203, 209, 13, 1, 13, 14, 4, 51, 4, 4, 4 ],
	[ 216, 204, 204, 204, 204, 204, 204, 209, 20, 14, 1, 4, 4, 6, 51, 52 ],
	[ 216, 204, 216, 203, 200, 204, 204, 204, 209, 1, 4, 4, 4, 51, 6, 4 ],
	[ 216, 216, 204, 204, 204, 203, 200, 204, 204, 209, 4, 4, 6, 51, 4, 6 ],
	[ 216, 204, 204, 204, 204, 204, 204, 200, 204, 204, 203, 203, 209, 4, 52, 4 ],
	[ 216, 204, 204, 204, 204, 204, 204, 204, 200, 204, 204, 204, 204, 203, 203, 209 ],
	[ 216, 204, 204, 204, 204, 204, 204, 204, 204, 203, 203, 200, 204, 204, 204, 201 ],
	[ 216, 204, 204, 204, 204, 216, 201, 204, 204, 204, 204, 204, 200, 204, 204, 201 ],
	[ 208, 204, 204, 204, 204, 201, 204, 216, 203, 200, 204, 204, 204, 200, 204, 201 ],
	[ 216, 208, 204, 204, 204, 204, 216, 204, 204, 204, 200, 204, 204, 202, 204, 201 ],
	[ 216, 204, 208, 204, 204, 204, 208, 204, 204, 204, 202, 204, 201, 204, 204, 201 ],
	[ 216, 204, 204, 208, 205, 204, 204, 208, 205, 202, 204, 204, 202, 204, 204, 210 ],
	[ 211, 205, 205, 204, 204, 208, 204, 204, 204, 204, 204, 202, 204, 204, 210, 51 ],
	[ 14, 14, 235, 211, 204, 204, 208, 205, 205, 205, 202, 204, 204, 210, 4, 4 ],
	[ 13, 1, 13, 13, 211, 204, 204, 204, 204, 204, 204, 204, 210, 4, 4, 4 ],
	[ 14, 10, 1, 14, 140, 211, 205, 205, 205, 205, 205, 210, 6, 4, 4, 4 ]
],
"objects": [
	{
		"class": "io.github.pokemeetup.system.gameplay.overworld.World$WorldObjectData",
		"x": -1024,
		"y": -19168,
		"type": "RAIN_TREE"
	},
	{
		"class": "io.github.pokemeetup.system.gameplay.overworld.World$WorldObjectData",
		"x": -576,
		"y": -19456,
		"type": "RAIN_TREE"
	},
	{
		"class": "io.github.pokemeetup.system.gameplay.overworld.World$WorldObjectData",
		"x": -544,
		"y": -19360,
		"type": "BUSH"
	}
],
"blocks": [],
"lastModified": 0,
"isMultiplayer": false
}