{
"x": -4,
"y": -41,
"biomeType": "SNOW",
"tileData": [
	[ 207, 203, 203, 203, 203, 203, 209, 4, 4, 216, 203, 203, 203, 209, 4, 51 ],
	[ 6, 216, 204, 204, 204, 204, 204, 203, 203, 204, 204, 204, 204, 204, 203, 209 ],
	[ 4, 216, 204, 204, 204, 204, 204, 204, 204, 204, 204, 204, 204, 204, 204, 201 ],
	[ 4, 216, 204, 204, 204, 204, 204, 204, 204, 204, 204, 204, 204, 204, 204, 201 ],
	[ 216, 204, 204, 204, 204, 216, 203, 200, 204, 216, 203, 203, 200, 204, 204, 201 ],
	[ 216, 204, 204, 204, 216, 204, 204, 204, 203, 204, 204, 204, 204, 200, 204, 201 ],
	[ 216, 204, 204, 204, 216, 204, 204, 204, 204, 204, 204, 204, 204, 201, 204, 201 ],
	[ 216, 204, 204, 204, 208, 204, 204, 204, 204, 204, 204, 204, 204, 202, 204, 201 ],
	[ 216, 204, 204, 204, 204, 208, 204, 204, 204, 204, 204, 204, 202, 204, 204, 201 ],
	[ 211, 204, 204, 204, 204, 204, 208, 205, 205, 205, 205, 202, 204, 204, 204, 201 ],
	[ 4, 211, 205, 204, 204, 204, 204, 204, 204, 204, 204, 204, 204, 204, 204, 201 ],
	[ 4, 51, 4, 211, 204, 204, 204, 204, 204, 204, 204, 204, 204, 204, 205, 210 ],
	[ 4, 4, 4, 51, 211, 205, 204, 204, 204, 204, 204, 204, 205, 210, 6, 4 ],
	[ 4, 6, 4, 4, 4, 51, 211, 205, 204, 205, 205, 210, 4, 4, 4, 4 ],
	[ 52, 4, 4, 4, 4, 4, 4, 6, 201, 4, 13, 14, 13, 14, 1, 14 ],
	[ 51, 4, 13, 14, 13, 13, 1, 20, 13, 14, 13, 14, 14, 20, 140, 13 ]
],
"objects": [],
"blocks": [],
"lastModified": 0,
"isMultiplayer": false
}