{
"x": 1,
"y": -16,
"biomeType": "HAUNTED",
"tileData": [
	[ 5, 1, 5, 5, 5, 7, 5, 5, 5, 5, 5, 5, 9, 8, 5, 5 ],
	[ 1, 1, 9, 5, 8, 8, 8, 7, 9, 5, 5, 7, 7, 1, 5, 5 ],
	[ 9, 5, 5, 5, 7, 7, 7, 5, 7, 5, 5, 7, 5, 5, 7, 5 ],
	[ 5, 5, 9, 5, 5, 8, 9, 5, 5, 5, 7, 5, 5, 7, 5, 5 ],
	[ 5, 5, 5, 5, 5, 7, 5, 5, 8, 9, 5, 5, 9, 5, 5, 5 ],
	[ 5, 7, 5, 5, 5, 5, 5, 9, 5, 7, 5, 5, 9, 7, 8, 7 ],
	[ 7, 5, 7, 9, 7, 5, 7, 5, 5, 5, 5, 5, 5, 7, 7, 5 ],
	[ 7, 5, 7, 5, 7, 5, 10, 8, 5, 9, 5, 5, 5, 7, 5, 5 ],
	[ 8, 5, 5, 5, 7, 5, 5, 9, 8, 5, 5, 5, 5, 7, 7, 5 ],
	[ 5, 5, 5, 8, 7, 5, 5, 5, 5, 7, 5, 8, 7, 7, 9, 5 ],
	[ 5, 7, 7, 5, 5, 7, 7, 7, 5, 5, 7, 5, 7, 7, 5, 7 ],
	[ 7, 5, 7, 7, 8, 5, 5, 5, 5, 8, 5, 5, 9, 5, 5, 9 ],
	[ 5, 7, 5, 5, 5, 5, 7, 7, 8, 7, 5, 5, 5, 5, 7, 7 ],
	[ 10, 5, 7, 7, 5, 7, 5, 5, 7, 7, 5, 5, 5, 5, 5, 5 ],
	[ 5, 7, 5, 5, 5, 5, 7, 7, 9, 7, 5, 5, 7, 5, 5, 5 ],
	[ 5, 5, 5, 5, 5, 5, 7, 9, 7, 8, 5, 5, 5, 7, 5, 9 ]
],
"objects": [
	{
		"class": "io.github.pokemeetup.system.gameplay.overworld.World$WorldObjectData",
		"x": 544,
		"y": -8160,
		"type": "SUNFLOWER"
	},
	{
		"class": "io.github.pokemeetup.system.gameplay.overworld.World$WorldObjectData",
		"x": 544,
		"y": -7776,
		"type": "POKEBALL"
	}
],
"blocks": [],
"lastModified": 0,
"isMultiplayer": false
}