{
"x": -2,
"y": -35,
"biomeType": "SNOW",
"tileData": [
	[ 4, 4, 4, 51, 4, 51, 4, 5, 5, 5, 7, 8, 5, 7, 5, 5 ],
	[ 4, 51, 4, 216, 203, 203, 203, 203, 203, 203, 203, 203, 203, 209, 5, 5 ],
	[ 4, 4, 216, 204, 204, 204, 204, 204, 204, 204, 204, 204, 204, 204, 203, 209 ],
	[ 4, 216, 204, 204, 204, 216, 203, 200, 204, 204, 204, 204, 204, 204, 204, 210 ],
	[ 4, 216, 204, 204, 216, 204, 204, 204, 203, 203, 203, 200, 204, 204, 201, 10 ],
	[ 6, 216, 204, 216, 204, 204, 204, 204, 204, 204, 204, 201, 204, 204, 201, 5 ],
	[ 4, 216, 204, 216, 204, 204, 204, 204, 204, 204, 204, 201, 204, 204, 210, 5 ],
	[ 4, 216, 204, 216, 204, 204, 204, 204, 204, 204, 204, 202, 204, 201, 5, 5 ],
	[ 4, 216, 204, 208, 204, 204, 204, 204, 204, 204, 201, 204, 204, 201, 235, 7 ],
	[ 4, 211, 204, 204, 216, 204, 204, 204, 204, 204, 202, 204, 204, 210, 5, 7 ],
	[ 4, 4, 216, 204, 208, 204, 204, 204, 204, 202, 204, 204, 210, 8, 5, 5 ],
	[ 4, 4, 211, 204, 204, 208, 204, 204, 202, 204, 204, 201, 5, 5, 5, 8 ],
	[ 4, 4, 4, 211, 204, 204, 208, 202, 204, 204, 204, 210, 5, 7, 8, 5 ],
	[ 14, 14, 14, 14, 216, 204, 204, 204, 204, 204, 210, 5, 8, 5, 7, 5 ],
	[ 13, 140, 13, 13, 211, 204, 204, 204, 204, 201, 4, 7, 7, 5, 5, 7 ],
	[ 13, 1, 24, 14, 14, 211, 205, 205, 205, 210, 140, 7, 5, 5, 5, 1 ]
],
"objects": [
	{
		"class": "io.github.pokemeetup.system.gameplay.overworld.World$WorldObjectData",
		"x": -544,
		"y": -17440,
		"type": "POKEBALL"
	}
],
"blocks": [],
"lastModified": 0,
"isMultiplayer": false
}