{
"x": 0,
"y": -37,
"biomeType": "RAIN_FOREST",
"tileData": [
	[ 4, 4, 51, 4, 14, 13, 14, 13, 14, 13, 140, 10, 14, 1, 14, 1 ],
	[ 51, 4, 20, 140, 14, 14, 13, 14, 1, 14, 10, 13, 10, 13, 140, 14 ],
	[ 6, 13, 13, 14, 1, 13, 14, 13, 14, 13, 13, 1, 13, 14, 13, 14 ],
	[ 140, 14, 10, 14, 13, 13, 13, 13, 14, 14, 140, 13, 14, 14, 13, 13 ],
	[ 14, 14, 14, 14, 14, 13, 13, 14, 1, 140, 14, 14, 1, 14, 1, 140 ],
	[ 14, 13, 13, 1, 14, 140, 1, 14, 13, 14, 13, 13, 1, 13, 140, 13 ],
	[ 13, 13, 140, 14, 140, 140, 14, 10, 13, 1, 10, 14, 10, 1, 140, 13 ],
	[ 13, 140, 13, 13, 1, 13, 14, 148, 144, 141, 20, 1, 14, 13, 14, 1 ],
	[ 14, 14, 1, 1, 10, 13, 13, 147, 140, 142, 14, 1, 14, 13, 14, 13 ],
	[ 140, 24, 140, 10, 14, 13, 1, 146, 145, 143, 13, 13, 13, 13, 13, 1 ],
	[ 140, 13, 14, 13, 14, 24, 1, 10, 13, 14, 14, 13, 1, 140, 14, 14 ],
	[ 14, 13, 1, 13, 140, 10, 13, 13, 13, 13, 13, 14, 14, 14, 13, 1 ],
	[ 14, 14, 14, 13, 13, 13, 14, 14, 13, 14, 1, 13, 1, 14, 20, 10 ],
	[ 1, 13, 140, 14, 14, 13, 14, 140, 13, 24, 20, 13, 13, 1, 140, 14 ],
	[ 14, 24, 140, 14, 140, 14, 13, 13, 14, 13, 14, 14, 1, 13, 13, 13 ],
	[ 1, 14, 140, 1, 10, 13, 13, 14, 14, 13, 140, 14, 140, 13, 13, 14 ]
],
"objects": [
	{
		"class": "io.github.pokemeetup.system.gameplay.overworld.World$WorldObjectData",
		"x": 224,
		"y": -18464,
		"type": "POKEBALL"
	}
],
"blocks": [],
"lastModified": 0,
"isMultiplayer": false
}