{
"x": -3,
"y": -36,
"biomeType": "SNOW",
"tileData": [
	[ 14, 13, 14, 4, 4, 216, 203, 203, 203, 203, 203, 209, 4, 4, 4, 4 ],
	[ 14, 1, 4, 4, 216, 204, 204, 204, 204, 204, 204, 204, 209, 51, 4, 4 ],
	[ 14, 4, 4, 4, 216, 204, 204, 204, 216, 200, 204, 204, 201, 4, 4, 4 ],
	[ 52, 4, 4, 4, 216, 204, 204, 216, 204, 204, 200, 204, 201, 6, 51, 4 ],
	[ 4, 6, 4, 4, 216, 204, 216, 204, 204, 204, 201, 204, 201, 4, 4, 4 ],
	[ 4, 52, 51, 216, 204, 216, 204, 204, 204, 204, 204, 200, 204, 209, 4, 51 ],
	[ 6, 6, 4, 216, 204, 216, 204, 204, 204, 204, 204, 201, 204, 201, 51, 4 ],
	[ 4, 4, 4, 216, 204, 216, 204, 204, 204, 204, 204, 201, 204, 201, 4, 4 ],
	[ 4, 51, 4, 216, 204, 216, 204, 204, 204, 204, 204, 201, 204, 201, 4, 4 ],
	[ 6, 4, 4, 216, 204, 216, 204, 204, 204, 204, 204, 201, 204, 201, 4, 4 ],
	[ 4, 4, 4, 211, 204, 208, 204, 204, 204, 204, 204, 202, 204, 201, 51, 4 ],
	[ 4, 4, 4, 4, 216, 204, 208, 204, 204, 204, 202, 204, 204, 210, 52, 4 ],
	[ 4, 51, 4, 4, 211, 204, 204, 208, 205, 202, 204, 204, 210, 4, 4, 4 ],
	[ 6, 4, 4, 4, 4, 211, 205, 235, 204, 205, 205, 210, 4, 4, 51, 4 ],
	[ 4, 4, 4, 4, 4, 4, 51, 4, 201, 4, 4, 4, 4, 51, 4, 4 ],
	[ 6, 4, 4, 4, 4, 6, 4, 4, 51, 4, 4, 4, 4, 4, 51, 6 ]
],
"objects": [
	{
		"class": "io.github.pokemeetup.system.gameplay.overworld.World$WorldObjectData",
		"x": -1504,
		"y": -18400,
		"type": "RAIN_TREE"
	}
],
"blocks": [],
"lastModified": 0,
"isMultiplayer": false
}