{
"x": -2,
"y": -37,
"biomeType": "SNOW",
"tileData": [
	[ 4, 4, 4, 4, 4, 4, 4, 4, 216, 203, 203, 203, 203, 203, 209, 4 ],
	[ 4, 4, 51, 4, 4, 4, 51, 216, 204, 204, 204, 204, 204, 204, 204, 209 ],
	[ 4, 52, 6, 4, 6, 216, 203, 204, 216, 203, 203, 203, 203, 203, 200, 201 ],
	[ 4, 6, 4, 216, 203, 204, 204, 216, 204, 204, 204, 204, 204, 204, 204, 200 ],
	[ 4, 216, 203, 204, 204, 216, 203, 204, 204, 216, 203, 203, 203, 200, 204, 201 ],
	[ 4, 216, 204, 204, 216, 204, 204, 204, 216, 204, 204, 204, 204, 204, 200, 201 ],
	[ 6, 216, 204, 216, 204, 204, 204, 216, 204, 204, 204, 204, 204, 204, 201, 201 ],
	[ 4, 216, 204, 216, 204, 204, 204, 208, 204, 204, 204, 204, 204, 204, 202, 201 ],
	[ 4, 211, 204, 208, 204, 204, 204, 204, 208, 204, 204, 204, 204, 202, 204, 201 ],
	[ 4, 4, 216, 204, 208, 204, 204, 204, 204, 208, 205, 205, 202, 204, 204, 201 ],
	[ 4, 4, 216, 204, 204, 208, 204, 204, 204, 204, 204, 204, 204, 204, 204, 202 ],
	[ 4, 4, 211, 204, 204, 204, 208, 205, 205, 204, 204, 204, 204, 204, 202, 201 ],
	[ 4, 6, 4, 211, 204, 204, 204, 204, 204, 208, 205, 205, 205, 202, 204, 201 ],
	[ 6, 51, 6, 4, 216, 204, 204, 204, 204, 204, 204, 204, 235, 205, 205, 210 ],
	[ 4, 4, 4, 4, 216, 204, 204, 204, 205, 205, 205, 210, 4, 6, 4, 51 ],
	[ 4, 6, 51, 4, 211, 205, 205, 210, 51, 4, 4, 4, 51, 4, 51, 4 ]
],
"objects": [
	{
		"class": "io.github.pokemeetup.system.gameplay.overworld.World$WorldObjectData",
		"x": -960,
		"y": -18848,
		"type": "SNOW_TREE"
	},
	{
		"class": "io.github.pokemeetup.system.gameplay.overworld.World$WorldObjectData",
		"x": -544,
		"y": -18496,
		"type": "SNOW_TREE"
	},
	{
		"class": "io.github.pokemeetup.system.gameplay.overworld.World$WorldObjectData",
		"x": -576,
		"y": -18944,
		"type": "SNOW_TREE"
	}
],
"blocks": [],
"lastModified": 0,
"isMultiplayer": false
}