{
"x": 1,
"y": -39,
"biomeType": "SNOW",
"tileData": [
	[ 14, 4, 216, 203, 216, 203, 203, 203, 203, 200, 203, 203, 203, 203, 209, 4 ],
	[ 1, 216, 204, 216, 204, 204, 204, 204, 204, 204, 203, 200, 204, 204, 204, 209 ],
	[ 14, 235, 216, 204, 204, 204, 204, 216, 203, 200, 204, 204, 203, 200, 204, 201 ],
	[ 216, 204, 216, 204, 204, 216, 203, 204, 204, 204, 200, 204, 204, 204, 200, 201 ],
	[ 216, 216, 204, 204, 216, 204, 204, 204, 204, 204, 204, 200, 204, 204, 202, 201 ],
	[ 216, 204, 204, 205, 216, 204, 204, 204, 204, 204, 204, 201, 204, 201, 204, 201 ],
	[ 216, 204, 235, 204, 216, 204, 204, 204, 204, 204, 204, 202, 204, 201, 204, 201 ],
	[ 216, 204, 216, 203, 204, 204, 204, 204, 204, 204, 202, 204, 204, 202, 204, 210 ],
	[ 216, 216, 204, 204, 204, 204, 204, 204, 205, 202, 204, 204, 201, 204, 201, 4 ],
	[ 216, 216, 204, 204, 204, 204, 204, 201, 204, 235, 204, 204, 202, 204, 201, 4 ],
	[ 216, 216, 204, 204, 204, 204, 204, 204, 200, 204, 204, 202, 204, 205, 210, 14 ],
	[ 216, 216, 204, 204, 204, 204, 204, 204, 201, 204, 201, 204, 201, 1, 14, 1 ],
	[ 216, 208, 204, 204, 204, 204, 204, 204, 202, 204, 201, 204, 201, 14, 140, 24 ],
	[ 216, 204, 208, 205, 205, 205, 205, 202, 204, 204, 202, 204, 210, 14, 14, 1 ],
	[ 208, 204, 204, 204, 204, 204, 204, 204, 204, 202, 204, 201, 14, 14, 14, 14 ],
	[ 211, 208, 205, 205, 205, 205, 205, 205, 202, 205, 205, 210, 13, 14, 14, 13 ]
],
"objects": [
	{
		"class": "io.github.pokemeetup.system.gameplay.overworld.World$WorldObjectData",
		"x": 992,
		"y": -19520,
		"type": "RAIN_TREE"
	},
	{
		"class": "io.github.pokemeetup.system.gameplay.overworld.World$WorldObjectData",
		"x": 864,
		"y": -19552,
		"type": "RAIN_TREE"
	},
	{
		"class": "io.github.pokemeetup.system.gameplay.overworld.World$WorldObjectData",
		"x": 512,
		"y": -19968,
		"type": "RAIN_TREE"
	},
	{
		"class": "io.github.pokemeetup.system.gameplay.overworld.World$WorldObjectData",
		"x": 864,
		"y": -19488,
		"type": "POKEBALL"
	}
],
"blocks": [],
"lastModified": 0,
"isMultiplayer": false
}