{
"x": 1,
"y": -38,
"biomeType": "RAIN_FOREST",
"tileData": [
	[ 4, 51, 51, 4, 4, 4, 14, 13, 13, 13, 13, 14, 14, 14, 14, 13 ],
	[ 4, 4, 4, 4, 4, 4, 14, 13, 1, 13, 1, 14, 13, 14, 1, 14 ],
	[ 51, 4, 4, 4, 4, 13, 14, 1, 13, 13, 14, 10, 13, 13, 13, 14 ],
	[ 4, 4, 4, 4, 4, 14, 140, 13, 140, 10, 13, 13, 13, 14, 14, 14 ],
	[ 4, 4, 4, 4, 14, 14, 140, 14, 10, 13, 14, 140, 20, 140, 140, 13 ],
	[ 6, 4, 4, 4, 13, 140, 1, 14, 14, 13, 13, 13, 140, 14, 13, 1 ],
	[ 4, 4, 4, 140, 140, 10, 13, 24, 13, 14, 14, 14, 13, 14, 24, 14 ],
	[ 4, 4, 1, 10, 14, 20, 14, 148, 144, 141, 14, 14, 14, 140, 14, 1 ],
	[ 4, 14, 140, 1, 10, 14, 13, 147, 140, 142, 1, 140, 13, 13, 14, 140 ],
	[ 1, 14, 14, 140, 14, 13, 13, 146, 145, 143, 140, 13, 14, 14, 14, 14 ],
	[ 140, 14, 14, 14, 14, 14, 14, 13, 13, 14, 14, 14, 13, 1, 13, 140 ],
	[ 1, 13, 140, 13, 14, 1, 14, 140, 140, 14, 14, 14, 140, 14, 13, 140 ],
	[ 140, 14, 13, 1, 14, 14, 140, 13, 14, 13, 1, 140, 20, 14, 14, 14 ],
	[ 14, 14, 140, 1, 14, 13, 140, 14, 13, 140, 14, 14, 1, 14, 13, 13 ],
	[ 13, 14, 13, 14, 13, 14, 14, 13, 1, 13, 14, 1, 14, 140, 13, 14 ],
	[ 1, 13, 13, 14, 14, 13, 14, 21, 14, 13, 20, 1, 13, 13, 13, 14 ]
],
"objects": [
	{
		"class": "io.github.pokemeetup.system.gameplay.overworld.World$WorldObjectData",
		"x": 576,
		"y": -19360,
		"type": "SNOW_TREE"
	},
	{
		"class": "io.github.pokemeetup.system.gameplay.overworld.World$WorldObjectData",
		"x": 992,
		"y": -19456,
		"type": "POKEBALL"
	}
],
"blocks": [],
"lastModified": 0,
"isMultiplayer": false
}