{
"x": -2,
"y": -36,
"biomeType": "SNOW",
"tileData": [
	[ 51, 4, 4, 4, 6, 4, 4, 4, 52, 4, 4, 4, 4, 4, 4, 4 ],
	[ 4, 6, 4, 4, 4, 4, 4, 4, 51, 4, 4, 4, 6, 4, 4, 4 ],
	[ 4, 4, 6, 6, 4, 6, 4, 6, 4, 4, 4, 216, 203, 203, 209, 4 ],
	[ 4, 4, 4, 4, 51, 4, 216, 203, 203, 235, 203, 204, 204, 204, 204, 209 ],
	[ 6, 4, 51, 216, 203, 235, 204, 204, 204, 216, 203, 203, 200, 204, 204, 201 ],
	[ 4, 4, 216, 204, 204, 216, 203, 203, 203, 204, 204, 204, 204, 200, 204, 201 ],
	[ 4, 216, 204, 204, 216, 204, 204, 204, 216, 203, 203, 200, 204, 201, 204, 201 ],
	[ 216, 204, 204, 216, 204, 204, 216, 203, 204, 204, 204, 204, 200, 204, 200, 201 ],
	[ 216, 204, 216, 204, 204, 216, 204, 204, 204, 204, 204, 204, 201, 204, 201, 201 ],
	[ 216, 204, 216, 204, 204, 216, 204, 204, 204, 204, 204, 204, 202, 204, 201, 201 ],
	[ 216, 204, 216, 204, 204, 216, 204, 204, 204, 204, 205, 202, 204, 204, 201, 201 ],
	[ 216, 204, 216, 204, 204, 208, 204, 204, 205, 202, 204, 204, 204, 204, 202, 201 ],
	[ 216, 204, 216, 204, 204, 204, 208, 202, 204, 204, 204, 204, 204, 202, 204, 201 ],
	[ 216, 204, 216, 204, 204, 204, 204, 204, 204, 204, 204, 204, 202, 204, 204, 201 ],
	[ 216, 204, 216, 204, 204, 204, 204, 204, 204, 204, 204, 202, 204, 204, 204, 210 ],
	[ 211, 205, 208, 205, 205, 205, 205, 205, 205, 205, 202, 205, 205, 205, 210, 13 ]
],
"objects": [
	{
		"class": "io.github.pokemeetup.system.gameplay.overworld.World$WorldObjectData",
		"x": -960,
		"y": -18336,
		"type": "SNOW_TREE"
	},
	{
		"class": "io.github.pokemeetup.system.gameplay.overworld.World$WorldObjectData",
		"x": -960,
		"y": -18176,
		"type": "SNOW_TREE"
	}
],
"blocks": [],
"lastModified": 0,
"isMultiplayer": false
}