{
"x": 0,
"y": -39,
"biomeType": "SNOW",
"tileData": [
	[ 216, 203, 203, 203, 203, 203, 203, 203, 209, 1, 13, 13, 4, 4, 4, 4 ],
	[ 216, 203, 203, 203, 203, 203, 200, 204, 204, 209, 13, 4, 4, 4, 6, 51 ],
	[ 208, 204, 204, 204, 204, 204, 204, 200, 204, 204, 209, 4, 4, 4, 6, 4 ],
	[ 216, 216, 204, 204, 204, 204, 204, 204, 200, 204, 201, 4, 4, 4, 51, 4 ],
	[ 216, 216, 204, 204, 204, 201, 204, 204, 204, 200, 204, 209, 51, 4, 4, 52 ],
	[ 216, 208, 204, 204, 204, 204, 204, 204, 204, 202, 204, 201, 4, 4, 4, 51 ],
	[ 216, 204, 208, 204, 204, 204, 204, 204, 201, 204, 204, 210, 4, 4, 6, 4 ],
	[ 216, 204, 204, 208, 204, 204, 204, 204, 202, 204, 201, 4, 4, 51, 4, 4 ],
	[ 211, 204, 204, 204, 208, 205, 205, 202, 204, 204, 210, 4, 6, 4, 4, 51 ],
	[ 1, 211, 205, 204, 204, 204, 204, 204, 204, 210, 4, 6, 4, 4, 4, 4 ],
	[ 13, 13, 14, 211, 204, 204, 204, 204, 210, 4, 4, 4, 4, 4, 4, 4 ],
	[ 13, 13, 1, 4, 211, 204, 205, 210, 4, 4, 6, 4, 4, 4, 4, 4 ],
	[ 14, 10, 4, 6, 4, 201, 4, 4, 4, 4, 4, 51, 4, 4, 4, 4 ],
	[ 20, 1, 4, 6, 51, 4, 4, 4, 4, 4, 4, 4, 4, 4, 4, 4 ],
	[ 10, 13, 6, 4, 4, 51, 4, 4, 51, 4, 4, 4, 4, 4, 51, 4 ],
	[ 14, 20, 4, 4, 4, 51, 4, 4, 51, 4, 4, 4, 6, 4, 4, 4 ]
],
"objects": [
	{
		"class": "io.github.pokemeetup.system.gameplay.overworld.World$WorldObjectData",
		"y": -19680,
		"type": "RAIN_TREE"
	},
	{
		"class": "io.github.pokemeetup.system.gameplay.overworld.World$WorldObjectData",
		"x": 448,
		"y": -19968,
		"type": "RAIN_TREE"
	},
	{
		"class": "io.github.pokemeetup.system.gameplay.overworld.World$WorldObjectData",
		"x": 352,
		"y": -19904,
		"type": "POKEBALL"
	}
],
"blocks": [],
"lastModified": 0,
"isMultiplayer": false
}