{
"x": 0,
"y": -38,
"biomeType": "SNOW",
"tileData": [
	[ 4, 4, 4, 216, 209, 6, 4, 4, 6, 4, 4, 4, 4, 4, 4, 4 ],
	[ 4, 4, 216, 204, 204, 209, 4, 4, 4, 4, 4, 6, 4, 6, 4, 4 ],
	[ 216, 203, 204, 204, 204, 204, 209, 4, 4, 51, 4, 4, 51, 4, 4, 4 ],
	[ 216, 204, 204, 204, 204, 204, 204, 203, 209, 4, 6, 51, 4, 4, 4, 14 ],
	[ 216, 204, 216, 203, 200, 204, 204, 204, 201, 4, 6, 4, 4, 4, 13, 14 ],
	[ 216, 216, 204, 204, 204, 200, 204, 204, 204, 209, 4, 4, 4, 14, 14, 13 ],
	[ 207, 204, 204, 204, 204, 204, 200, 204, 204, 201, 51, 4, 14, 13, 14, 1 ],
	[ 216, 216, 204, 204, 204, 204, 204, 200, 204, 201, 4, 20, 14, 14, 13, 13 ],
	[ 216, 208, 204, 204, 204, 204, 204, 201, 204, 201, 235, 14, 140, 140, 1, 13 ],
	[ 216, 204, 208, 204, 204, 204, 204, 202, 204, 210, 10, 20, 13, 140, 13, 14 ],
	[ 216, 204, 204, 208, 204, 204, 202, 204, 201, 140, 13, 20, 14, 14, 14, 14 ],
	[ 211, 204, 204, 204, 208, 202, 204, 204, 210, 1, 13, 13, 14, 140, 10, 1 ],
	[ 4, 211, 204, 204, 204, 204, 204, 210, 20, 10, 14, 14, 14, 13, 14, 13 ],
	[ 4, 51, 216, 204, 204, 204, 210, 4, 1, 10, 14, 13, 10, 140, 1, 13 ],
	[ 51, 4, 211, 205, 205, 210, 4, 14, 10, 13, 140, 1, 13, 140, 14, 10 ],
	[ 6, 4, 4, 4, 4, 4, 51, 13, 13, 13, 14, 140, 14, 1, 14, 13 ]
],
"objects": [
	{
		"class": "io.github.pokemeetup.system.gameplay.overworld.World$WorldObjectData",
		"x": 64,
		"y": -19200,
		"type": "SNOW_TREE"
	},
	{
		"class": "io.github.pokemeetup.system.gameplay.overworld.World$WorldObjectData",
		"x": 448,
		"y": -19456,
		"type": "SNOW_TREE"
	},
	{
		"class": "io.github.pokemeetup.system.gameplay.overworld.World$WorldObjectData",
		"x": 192,
		"y": -18976,
		"type": "POKEBALL"
	}
],
"blocks": [],
"lastModified": 0,
"isMultiplayer": false
}