{
"x": -1,
"y": -36,
"biomeType": "RAIN_FOREST",
"tileData": [
	[ 4, 4, 51, 52, 51, 6, 4, 4, 4, 4, 13, 1, 21, 13, 13, 140 ],
	[ 4, 4, 4, 4, 4, 6, 4, 4, 4, 14, 140, 13, 140, 13, 14, 14 ],
	[ 4, 52, 4, 51, 4, 4, 4, 4, 14, 14, 13, 13, 13, 14, 1, 1 ],
	[ 51, 4, 4, 6, 4, 4, 14, 14, 13, 14, 13, 13, 1, 20, 14, 14 ],
	[ 4, 6, 4, 4, 4, 13, 1, 14, 14, 13, 13, 13, 14, 13, 14, 1 ],
	[ 4, 4, 4, 4, 14, 140, 13, 1, 10, 13, 14, 13, 13, 13, 20, 13 ],
	[ 4, 4, 4, 1, 21, 13, 14, 10, 13, 14, 1, 13, 13, 14, 14, 14 ],
	[ 4, 4, 14, 14, 13, 13, 13, 148, 144, 141, 140, 13, 1, 14, 13, 13 ],
	[ 4, 140, 20, 14, 14, 13, 13, 147, 140, 142, 140, 10, 13, 14, 14, 1 ],
	[ 14, 14, 14, 10, 14, 13, 13, 146, 145, 143, 20, 140, 14, 14, 13, 10 ],
	[ 14, 140, 1, 14, 13, 14, 14, 14, 13, 140, 14, 14, 1, 20, 140, 1 ],
	[ 140, 14, 14, 13, 13, 14, 14, 14, 13, 13, 13, 10, 13, 13, 24, 14 ],
	[ 14, 14, 14, 1, 1, 14, 14, 1, 140, 14, 14, 1, 13, 14, 140, 13 ],
	[ 14, 14, 14, 14, 20, 14, 14, 24, 14, 13, 1, 20, 13, 14, 14, 13 ],
	[ 13, 1, 13, 13, 10, 13, 14, 14, 14, 14, 13, 14, 1, 10, 13, 1 ],
	[ 13, 14, 13, 14, 14, 13, 14, 1, 14, 14, 14, 20, 14, 14, 14, 20 ]
],
"objects": [
	{
		"class": "io.github.pokemeetup.system.gameplay.overworld.World$WorldObjectData",
		"x": -448,
		"y": -18336,
		"type": "SNOW_TREE"
	},
	{
		"class": "io.github.pokemeetup.system.gameplay.overworld.World$WorldObjectData",
		"x": -512,
		"y": -18144,
		"type": "SNOW_TREE"
	},
	{
		"class": "io.github.pokemeetup.system.gameplay.overworld.World$WorldObjectData",
		"x": -256,
		"y": -17952,
		"type": "POKEBALL"
	}
],
"blocks": [],
"lastModified": 0,
"isMultiplayer": false
}