{
"x": -3,
"y": -42,
"biomeType": "RAIN_FOREST",
"tileData": [
	[ 4, 4, 4, 4, 4, 4, 6, 6, 51, 4, 4, 4, 4, 51, 14, 13 ],
	[ 4, 4, 4, 4, 4, 51, 51, 4, 4, 4, 20, 20, 14, 140, 140, 140 ],
	[ 4, 4, 51, 4, 51, 51, 14, 14, 14, 14, 1, 1, 13, 1, 14, 13 ],
	[ 4, 51, 4, 14, 1, 14, 14, 14, 140, 14, 14, 14, 14, 13, 14, 14 ],
	[ 13, 14, 13, 21, 13, 14, 13, 20, 14, 14, 13, 1, 140, 13, 13, 1 ],
	[ 140, 13, 14, 1, 13, 13, 14, 14, 1, 21, 13, 13, 14, 13, 14, 14 ],
	[ 13, 14, 10, 13, 13, 14, 14, 14, 1, 14, 140, 14, 13, 20, 1, 14 ],
	[ 13, 1, 14, 13, 14, 14, 13, 148, 144, 141, 13, 14, 20, 14, 13, 1 ],
	[ 14, 140, 13, 20, 14, 1, 10, 147, 140, 142, 13, 14, 140, 13, 10, 14 ],
	[ 13, 13, 1, 10, 14, 13, 20, 146, 145, 143, 14, 1, 20, 14, 13, 14 ],
	[ 14, 14, 14, 13, 10, 14, 14, 13, 14, 14, 14, 13, 21, 13, 13, 1 ],
	[ 14, 14, 14, 14, 10, 13, 13, 140, 20, 13, 14, 10, 14, 13, 13, 20 ],
	[ 13, 14, 140, 13, 140, 14, 14, 14, 13, 13, 140, 140, 14, 14, 14, 10 ],
	[ 20, 140, 14, 14, 13, 20, 1, 14, 1, 14, 13, 13, 14, 14, 20, 14 ],
	[ 1, 14, 140, 13, 1, 13, 14, 1, 21, 14, 14, 1, 14, 14, 140, 1 ],
	[ 14, 13, 13, 14, 13, 140, 14, 14, 13, 14, 13, 13, 10, 14, 1, 13 ]
],
"objects": [
	{
		"class": "io.github.pokemeetup.system.gameplay.overworld.World$WorldObjectData",
		"x": -1472,
		"y": -21408,
		"type": "SNOW_TREE"
	},
	{
		"class": "io.github.pokemeetup.system.gameplay.overworld.World$WorldObjectData",
		"x": -1536,
		"y": -21216,
		"type": "SNOW_TREE"
	},
	{
		"class": "io.github.pokemeetup.system.gameplay.overworld.World$WorldObjectData",
		"x": -1376,
		"y": -21408,
		"type": "POKEBALL"
	}
],
"blocks": [],
"lastModified": 0,
"isMultiplayer": false
}