{
"x": -4,
"y": -40,
"biomeType": "SNOW",
"tileData": [
	[ 4, 4, 4, 51, 52, 4, 4, 4, 4, 4, 4, 4, 51, 51, 4, 4 ],
	[ 4, 4, 4, 51, 4, 4, 4, 4, 4, 51, 4, 4, 4, 4, 4, 4 ],
	[ 4, 4, 52, 4, 4, 216, 203, 203, 209, 4, 4, 4, 4, 4, 4, 4 ],
	[ 51, 4, 4, 6, 216, 204, 204, 204, 204, 203, 209, 4, 4, 4, 4, 52 ],
	[ 201, 51, 216, 203, 204, 204, 204, 204, 204, 204, 204, 209, 4, 4, 4, 4 ],
	[ 216, 203, 204, 204, 204, 204, 204, 204, 204, 204, 204, 204, 203, 209, 6, 51 ],
	[ 216, 204, 204, 204, 204, 216, 203, 203, 200, 204, 204, 204, 204, 204, 209, 52 ],
	[ 216, 204, 204, 204, 216, 204, 204, 204, 204, 203, 200, 204, 204, 204, 201, 4 ],
	[ 216, 204, 204, 204, 216, 204, 204, 204, 204, 204, 204, 200, 204, 204, 204, 209 ],
	[ 216, 204, 204, 204, 208, 204, 204, 204, 204, 204, 204, 204, 200, 204, 204, 201 ],
	[ 211, 204, 204, 204, 204, 208, 204, 204, 204, 204, 204, 204, 201, 204, 204, 201 ],
	[ 4, 211, 204, 204, 204, 204, 208, 205, 205, 204, 204, 204, 202, 204, 204, 201 ],
	[ 6, 51, 211, 204, 204, 204, 204, 204, 204, 208, 205, 202, 204, 204, 204, 201 ],
	[ 4, 4, 4, 211, 204, 204, 204, 204, 204, 204, 204, 204, 204, 204, 204, 201 ],
	[ 13, 13, 1, 14, 211, 205, 205, 205, 204, 204, 204, 204, 204, 204, 204, 201 ],
	[ 14, 140, 10, 14, 1, 14, 13, 13, 211, 205, 205, 205, 205, 205, 205, 210 ]
],
"objects": [
	{
		"class": "io.github.pokemeetup.system.gameplay.overworld.World$WorldObjectData",
		"x": -1984,
		"y": -20384,
		"type": "SNOW_TREE"
	},
	{
		"class": "io.github.pokemeetup.system.gameplay.overworld.World$WorldObjectData",
		"x": -2048,
		"y": -20192,
		"type": "SNOW_TREE"
	}
],
"blocks": [],
"lastModified": 0,
"isMultiplayer": false
}