{
"x": -98,
"y": -9,
"biomeType": "DESERT",
"tileData": [
	[ 1, 10, 1, 10, 1, 15, 1, 1, 15, 2, 5, 9, 5, 7, 9, 7 ],
	[ 24, 10, 24, 10, 10, 1, 15, 2, 15, 16, 15, 2, 5, 7, 5, 7 ],
	[ 10, 1, 1, 1, 10, 15, 2, 16, 2, 15, 2, 15, 15, 15, 7, 9 ],
	[ 1, 24, 15, 1, 1, 23, 15, 15, 15, 2, 15, 2, 15, 2, 2, 16 ],
	[ 1, 10, 1, 17, 24, 15, 15, 15, 15, 15, 15, 16, 17, 15, 2, 15 ],
	[ 1, 1, 1, 16, 15, 16, 15, 15, 15, 15, 15, 2, 15, 15, 15, 15 ],
	[ 1, 1, 17, 15, 15, 2, 15, 15, 17, 15, 15, 15, 16, 15, 15, 15 ],
	[ 10, 1, 10, 15, 15, 2, 15, 17, 16, 15, 16, 15, 15, 15, 15, 15 ],
	[ 1, 24, 15, 15, 2, 15, 15, 15, 15, 15, 2, 15, 15, 15, 2, 15 ],
	[ 23, 15, 2, 15, 15, 15, 2, 15, 15, 15, 15, 15, 15, 15, 2, 15 ],
	[ 15, 15, 2, 15, 15, 15, 2, 16, 2, 15, 15, 15, 15, 2, 15, 15 ],
	[ 15, 15, 15, 15, 16, 15, 2, 17, 15, 15, 17, 15, 15, 15, 16, 15 ],
	[ 2, 15, 17, 15, 2, 15, 2, 2, 15, 17, 16, 2, 16, 15, 15, 15 ],
	[ 15, 15, 15, 15, 16, 15, 15, 15, 17, 17, 15, 16, 15, 15, 15, 2 ],
	[ 15, 15, 16, 15, 15, 15, 15, 15, 16, 15, 15, 2, 15, 15, 15, 15 ],
	[ 2, 15, 15, 15, 15, 15, 17, 15, 15, 15, 16, 2, 15, 15, 17, 15 ]
],
"objects": [
	{
		"class": "io.github.pokemeetup.system.gameplay.overworld.World$WorldObjectData",
		"x": -50080,
		"y": -4576,
		"type": "TREE_0"
	},
	{
		"class": "io.github.pokemeetup.system.gameplay.overworld.World$WorldObjectData",
		"x": -50080,
		"y": -4448,
		"type": "TREE_0"
	},
	{
		"class": "io.github.pokemeetup.system.gameplay.overworld.World$WorldObjectData",
		"x": -49984,
		"y": -4576,
		"type": "TREE_1"
	},
	{
		"class": "io.github.pokemeetup.system.gameplay.overworld.World$WorldObjectData",
		"x": -50080,
		"y": -4256,
		"type": "POKEBALL"
	}
],
"blocks": [],
"lastModified": 0,
"isMultiplayer": false
}