{
"x": -118,
"y": -12,
"biomeType": "PLAINS",
"tileData": [
	[ 1, 1, 11, 12, 11, 11, 12, 1, 11, 1, 1, 1, 1, 1, 10, 1 ],
	[ 11, 12, 11, 11, 11, 1, 12, 12, 12, 10, 10, 1, 10, 1, 10, 1 ],
	[ 11, 1, 11, 11, 1, 12, 1, 11, 1, 1, 1, 24, 10, 1, 1, 10 ],
	[ 11, 1, 1, 10, 10, 24, 10, 1, 1, 1, 24, 24, 24, 1, 10, 10 ],
	[ 11, 1, 1, 10, 10, 1, 1, 1, 1, 10, 22, 1, 1, 24, 1, 1 ],
	[ 11, 10, 10, 10, 10, 10, 10, 1, 10, 10, 10, 1, 24, 1, 1, 1 ],
	[ 1, 10, 1, 10, 10, 10, 1, 1, 1, 1, 10, 5, 1, 10, 7, 23 ],
	[ 24, 1, 1, 10, 10, 10, 10, 1, 10, 1, 1, 1, 5, 1, 5, 10 ],
	[ 1, 10, 10, 10, 10, 5, 7, 10, 7, 1, 5, 1, 7, 7, 5, 7 ],
	[ 24, 1, 1, 5, 1, 9, 10, 1, 1, 5, 5, 9, 9, 8, 5, 7 ],
	[ 1, 5, 1, 5, 5, 1, 10, 5, 5, 5, 5, 5, 5, 5, 9, 5 ],
	[ 10, 10, 5, 1, 7, 7, 5, 5, 5, 1, 1, 5, 5, 1, 5, 5 ],
	[ 5, 1, 7, 5, 5, 5, 5, 5, 7, 7, 5, 5, 7, 5, 5, 5 ],
	[ 10, 7, 5, 5, 5, 5, 5, 7, 8, 9, 5, 7, 5, 5, 5, 7 ],
	[ 5, 7, 7, 5, 5, 5, 5, 5, 8, 9, 7, 5, 5, 7, 8, 5 ],
	[ 7, 7, 5, 5, 5, 9, 7, 5, 7, 5, 5, 5, 7, 10, 5, 7 ]
],
"objects": [
	{
		"class": "io.github.pokemeetup.system.gameplay.overworld.World$WorldObjectData",
		"x": -60288,
		"y": -5920,
		"type": "POKEBALL"
	}
],
"blocks": [],
"lastModified": 0,
"isMultiplayer": false
}