{
"x": -149,
"y": -4,
"biomeType": "DESERT",
"tileData": [
	[ 1, 10, 15, 15, 15, 16, 17, 15, 17, 15, 15, 15, 2, 15, 15, 16 ],
	[ 10, 17, 15, 15, 2, 15, 17, 2, 15, 15, 15, 2, 15, 2, 15, 17 ],
	[ 15, 15, 15, 15, 2, 15, 16, 15, 15, 15, 15, 16, 16, 15, 15, 15 ],
	[ 15, 15, 2, 15, 17, 15, 15, 2, 15, 15, 15, 15, 15, 17, 15, 15 ],
	[ 15, 17, 15, 2, 15, 2, 15, 15, 15, 2, 15, 15, 2, 2, 15, 15 ],
	[ 17, 15, 15, 15, 16, 15, 15, 2, 16, 15, 17, 17, 15, 2, 15, 15 ],
	[ 15, 15, 15, 16, 2, 15, 15, 2, 2, 16, 17, 2, 2, 15, 15, 15 ],
	[ 15, 15, 15, 15, 15, 15, 15, 15, 15, 15, 15, 2, 15, 17, 2, 15 ],
	[ 2, 16, 15, 15, 15, 2, 15, 17, 2, 15, 15, 15, 16, 15, 2, 2 ],
	[ 2, 15, 15, 17, 15, 15, 15, 15, 15, 15, 15, 15, 15, 17, 15, 15 ],
	[ 15, 15, 15, 15, 15, 15, 15, 15, 2, 15, 2, 15, 15, 2, 2, 15 ],
	[ 15, 15, 16, 15, 16, 15, 2, 15, 15, 2, 17, 17, 15, 15, 15, 15 ],
	[ 15, 15, 17, 15, 15, 15, 15, 15, 16, 15, 17, 16, 15, 2, 15, 15 ],
	[ 2, 15, 15, 15, 15, 15, 2, 15, 17, 17, 2, 15, 15, 17, 15, 15 ],
	[ 15, 16, 15, 15, 15, 15, 15, 15, 15, 2, 15, 15, 15, 15, 15, 15 ],
	[ 15, 16, 15, 15, 15, 15, 15, 15, 2, 15, 15, 15, 15, 15, 2, 16 ]
],
"objects": [
	{
		"class": "io.github.pokemeetup.system.gameplay.overworld.World$WorldObjectData",
		"x": -76288,
		"y": -2016,
		"type": "APRICORN_TREE"
	},
	{
		"class": "io.github.pokemeetup.system.gameplay.overworld.World$WorldObjectData",
		"x": -76096,
		"y": -1696,
		"type": "POKEBALL"
	}
],
"blocks": [],
"lastModified": 0,
"isMultiplayer": false
}