{
"x": -32,
"y": -5,
"biomeType": "SNOW",
"tileData": [
	[ 5, 7, 7, 7, 5, 7, 7, 5, 7, 6, 4, 51, 6, 4, 4, 4 ],
	[ 7, 7, 5, 5, 7, 7, 5, 4, 4, 51, 51, 6, 6, 4, 4, 4 ],
	[ 7, 7, 5, 7, 5, 4, 4, 4, 51, 6, 6, 4, 4, 6, 4, 52 ],
	[ 8, 7, 8, 4, 4, 4, 4, 4, 4, 51, 4, 4, 4, 4, 4, 4 ],
	[ 7, 4, 4, 4, 4, 6, 4, 4, 4, 4, 4, 4, 4, 4, 4, 4 ],
	[ 52, 4, 6, 4, 4, 4, 4, 4, 4, 4, 4, 4, 4, 4, 6, 4 ],
	[ 4, 4, 6, 51, 4, 4, 4, 4, 4, 4, 4, 4, 4, 4, 4, 4 ],
	[ 4, 4, 4, 4, 4, 4, 4, 4, 4, 4, 4, 6, 4, 6, 4, 4 ],
	[ 4, 6, 4, 51, 6, 4, 4, 4, 4, 51, 4, 4, 4, 4, 4, 4 ],
	[ 4, 4, 4, 4, 4, 4, 4, 4, 51, 4, 4, 4, 6, 4, 51, 4 ],
	[ 51, 4, 6, 4, 4, 4, 4, 4, 4, 51, 4, 4, 4, 52, 4, 6 ],
	[ 4, 6, 4, 4, 4, 4, 4, 6, 4, 4, 4, 4, 4, 4, 4, 4 ],
	[ 4, 4, 52, 4, 4, 4, 4, 51, 4, 4, 4, 4, 4, 4, 4, 6 ],
	[ 4, 4, 4, 4, 4, 4, 6, 51, 4, 4, 51, 6, 4, 6, 4, 4 ],
	[ 4, 4, 6, 4, 4, 4, 4, 4, 6, 6, 4, 4, 6, 4, 4, 4 ],
	[ 4, 51, 4, 52, 6, 4, 4, 51, 51, 6, 6, 6, 4, 4, 4, 4 ]
],
"objects": [
	{
		"class": "io.github.pokemeetup.system.gameplay.overworld.World$WorldObjectData",
		"x": -16288,
		"y": -2528,
		"type": "HAUNTED_TREE"
	},
	{
		"class": "io.github.pokemeetup.system.gameplay.overworld.World$WorldObjectData",
		"x": -16352,
		"y": -2368,
		"type": "HAUNTED_TREE"
	},
	{
		"class": "io.github.pokemeetup.system.gameplay.overworld.World$WorldObjectData",
		"x": -16384,
		"y": -2528,
		"type": "HAUNTED_TREE"
	}
],
"blocks": [],
"lastModified": 0,
"isMultiplayer": false
}