{
"x": -145,
"y": -16,
"biomeType": "FOREST",
"tileData": [
	[ 15, 15, 15, 15, 10, 1, 11, 11, 11, 1, 11, 11, 11, 11, 11, 1 ],
	[ 15, 15, 2, 2, 1, 11, 11, 1, 11, 11, 12, 12, 11, 12, 11, 10 ],
	[ 15, 15, 15, 15, 11, 11, 12, 10, 11, 11, 12, 11, 12, 11, 11, 11 ],
	[ 15, 15, 15, 11, 11, 12, 12, 11, 11, 12, 11, 11, 10, 11, 12, 1 ],
	[ 15, 2, 15, 12, 11, 11, 11, 11, 12, 11, 11, 10, 12, 12, 11, 1 ],
	[ 17, 15, 11, 11, 12, 12, 20, 11, 11, 11, 1, 11, 11, 12, 10, 1 ],
	[ 15, 11, 12, 11, 11, 11, 10, 11, 20, 11, 11, 11, 1, 10, 1, 10 ],
	[ 11, 10, 12, 11, 11, 11, 11, 11, 1, 11, 11, 10, 11, 1, 10, 24 ],
	[ 1, 12, 12, 11, 11, 11, 11, 10, 1, 1, 1, 10, 1, 1, 10, 1 ],
	[ 11, 11, 11, 11, 11, 11, 12, 11, 11, 12, 24, 11, 1, 10, 1, 24 ],
	[ 11, 1, 1, 11, 10, 1, 1, 10, 1, 11, 11, 1, 1, 24, 10, 1 ],
	[ 1, 11, 1, 11, 10, 10, 10, 12, 1, 10, 1, 10, 1, 23, 10, 10 ],
	[ 10, 1, 1, 24, 1, 1, 24, 10, 1, 1, 1, 10, 1, 10, 10, 1 ],
	[ 1, 1, 1, 10, 24, 24, 10, 1, 10, 24, 1, 1, 1, 10, 1, 1 ],
	[ 10, 22, 1, 10, 1, 1, 10, 1, 1, 24, 1, 10, 1, 1, 1, 5 ],
	[ 1, 1, 1, 1, 1, 10, 1, 10, 22, 10, 24, 10, 5, 5, 7, 7 ]
],
"objects": [
	{
		"class": "io.github.pokemeetup.system.gameplay.overworld.World$WorldObjectData",
		"x": -74144,
		"y": -8160,
		"type": "CACTUS"
	},
	{
		"class": "io.github.pokemeetup.system.gameplay.overworld.World$WorldObjectData",
		"x": -74080,
		"y": -8192,
		"type": "DEAD_TREE"
	},
	{
		"class": "io.github.pokemeetup.system.gameplay.overworld.World$WorldObjectData",
		"x": -74080,
		"y": -7872,
		"type": "POKEBALL"
	}
],
"blocks": [],
"lastModified": 0,
"isMultiplayer": false
}