{
"x": -10,
"y": -3,
"biomeType": "PLAINS",
"tileData": [
	[ 15, 15, 17, 17, 16, 17, 15, 15, 16, 2, 1, 5, 5, 5, 10, 1 ],
	[ 15, 1, 1, 10, 1, 1, 10, 1, 10, 24, 8, 5, 5, 10, 22, 9 ],
	[ 24, 24, 22, 10, 1, 10, 10, 1, 1, 1, 5, 5, 1, 1, 10, 1 ],
	[ 1, 24, 1, 10, 1, 24, 1, 10, 10, 10, 1, 10, 10, 10, 10, 1 ],
	[ 24, 1, 1, 10, 10, 10, 1, 1, 1, 1, 1, 10, 1, 1, 1, 10 ],
	[ 1, 10, 1, 1, 1, 1, 1, 1, 1, 1, 10, 10, 1, 22, 10, 1 ],
	[ 10, 10, 1, 10, 10, 10, 1, 1, 10, 10, 10, 1, 10, 10, 1, 10 ],
	[ 1, 24, 10, 24, 1, 10, 10, 10, 10, 1, 1, 10, 10, 10, 1, 1 ],
	[ 1, 24, 1, 1, 10, 10, 1, 1, 24, 10, 1, 1, 1, 1, 24, 10 ],
	[ 10, 1, 10, 1, 1, 10, 10, 1, 1, 1, 1, 10, 1, 22, 10, 1 ],
	[ 10, 1, 1, 1, 1, 10, 24, 1, 1, 1, 1, 10, 1, 10, 1, 1 ],
	[ 1, 1, 1, 10, 1, 1, 10, 10, 1, 1, 10, 22, 1, 12, 22, 11 ],
	[ 10, 10, 1, 24, 1, 1, 10, 10, 1, 1, 10, 1, 10, 1, 1, 11 ],
	[ 10, 1, 24, 1, 1, 1, 15, 10, 10, 24, 10, 10, 1, 1, 11, 11 ],
	[ 15, 15, 2, 1, 1, 15, 1, 1, 22, 24, 1, 11, 11, 11, 11, 1 ],
	[ 2, 2, 15, 15, 15, 15, 15, 2, 15, 17, 11, 12, 11, 1, 12, 11 ]
],
"objects": [
	{
		"class": "io.github.pokemeetup.system.gameplay.overworld.World$WorldObjectData",
		"x": -4704,
		"y": -1344,
		"type": "CACTUS"
	},
	{
		"class": "io.github.pokemeetup.system.gameplay.overworld.World$WorldObjectData",
		"x": -4640,
		"y": -1312,
		"type": "DEAD_TREE"
	},
	{
		"class": "io.github.pokemeetup.system.gameplay.overworld.World$WorldObjectData",
		"x": -4896,
		"y": -1408,
		"type": "POKEBALL"
	}
],
"blocks": [],
"lastModified": 0,
"isMultiplayer": false
}