{
"x": -157,
"y": -7,
"biomeType": "PLAINS",
"tileData": [
	[ 6, 4, 4, 1, 1, 1, 1, 10, 1, 10, 1, 10, 10, 1, 10, 1 ],
	[ 4, 51, 51, 10, 10, 1, 10, 24, 1, 1, 10, 1, 1, 1, 1, 1 ],
	[ 4, 4, 1, 1, 1, 1, 1, 1, 10, 1, 1, 10, 10, 1, 1, 1 ],
	[ 4, 4, 1, 1, 1, 1, 1, 24, 1, 1, 1, 1, 1, 1, 1, 1 ],
	[ 4, 4, 10, 1, 24, 1, 24, 10, 1, 1, 10, 10, 10, 1, 1, 10 ],
	[ 4, 10, 1, 24, 1, 24, 1, 1, 1, 10, 10, 1, 1, 10, 1, 1 ],
	[ 4, 1, 24, 1, 24, 10, 1, 1, 1, 1, 1, 1, 10, 1, 1, 24 ],
	[ 10, 24, 10, 10, 24, 1, 1, 10, 1, 1, 1, 1, 1, 1, 10, 24 ],
	[ 1, 1, 10, 1, 1, 1, 24, 1, 1, 10, 10, 1, 1, 1, 10, 1 ],
	[ 1, 24, 24, 1, 1, 1, 10, 1, 24, 10, 1, 1, 1, 10, 1, 10 ],
	[ 24, 1, 1, 1, 24, 24, 10, 10, 1, 1, 1, 10, 1, 10, 24, 24 ],
	[ 1, 1, 10, 1, 10, 1, 10, 10, 1, 1, 1, 1, 24, 1, 24, 1 ],
	[ 1, 1, 1, 24, 24, 1, 10, 10, 1, 24, 1, 10, 1, 10, 1, 1 ],
	[ 10, 10, 1, 22, 10, 10, 1, 1, 1, 24, 1, 10, 10, 1, 1, 24 ],
	[ 1, 1, 10, 10, 10, 10, 1, 24, 22, 10, 1, 24, 1, 1, 10, 1 ],
	[ 10, 1, 1, 1, 10, 10, 10, 10, 10, 1, 10, 10, 1, 10, 1, 10 ]
],
"objects": [
	{
		"class": "io.github.pokemeetup.system.gameplay.overworld.World$WorldObjectData",
		"x": -80288,
		"y": -3552,
		"type": "SNOW_TREE"
	},
	{
		"class": "io.github.pokemeetup.system.gameplay.overworld.World$WorldObjectData",
		"x": -80064,
		"y": -3296,
		"type": "POKEBALL"
	}
],
"blocks": [],
"lastModified": 0,
"isMultiplayer": false
}