{
"x": -31,
"y": -6,
"biomeType": "SNOW",
"tileData": [
	[ 5, 4, 51, 4, 4, 4, 4, 4, 4, 4, 4, 4, 4, 4, 52, 4 ],
	[ 52, 6, 4, 6, 6, 6, 4, 4, 6, 4, 6, 4, 4, 4, 6, 6 ],
	[ 4, 4, 4, 4, 4, 4, 4, 51, 4, 4, 6, 4, 4, 4, 4, 4 ],
	[ 52, 51, 4, 6, 4, 6, 4, 4, 4, 51, 4, 4, 4, 51, 4, 4 ],
	[ 52, 4, 4, 4, 4, 4, 4, 4, 4, 4, 4, 4, 52, 51, 4, 6 ],
	[ 4, 4, 4, 4, 4, 51, 4, 51, 4, 4, 4, 4, 4, 6, 6, 4 ],
	[ 4, 4, 4, 4, 6, 4, 4, 4, 51, 4, 4, 4, 51, 4, 4, 4 ],
	[ 4, 4, 6, 4, 4, 4, 52, 4, 4, 4, 51, 4, 51, 6, 4, 4 ],
	[ 4, 6, 4, 4, 6, 4, 4, 4, 4, 6, 4, 51, 4, 4, 4, 6 ],
	[ 4, 4, 4, 4, 4, 4, 4, 52, 4, 51, 6, 4, 4, 4, 4, 6 ],
	[ 4, 51, 4, 4, 4, 4, 4, 4, 4, 4, 4, 4, 4, 6, 4, 51 ],
	[ 4, 4, 4, 52, 4, 52, 4, 4, 6, 4, 6, 4, 51, 4, 4, 4 ],
	[ 4, 4, 4, 4, 4, 4, 51, 6, 4, 4, 4, 6, 52, 4, 4, 4 ],
	[ 6, 4, 51, 6, 4, 6, 4, 6, 4, 51, 6, 4, 4, 6, 4, 51 ],
	[ 6, 4, 51, 51, 4, 6, 4, 4, 6, 6, 51, 4, 52, 4, 4, 4 ],
	[ 4, 4, 4, 4, 51, 52, 4, 4, 6, 51, 51, 4, 4, 6, 4, 51 ]
],
"objects": [
	{
		"class": "io.github.pokemeetup.system.gameplay.overworld.World$WorldObjectData",
		"x": -15872,
		"y": -3072,
		"type": "SMALL_HAUNTED_TREE"
	}
],
"blocks": [],
"lastModified": 0,
"isMultiplayer": false
}