{
"x": -26,
"y": 1,
"biomeType": "PLAINS",
"tileData": [
	[ 11, 4, 4, 11, 1, 1, 1, 1, 24, 1, 1, 1, 10, 10, 10, 10 ],
	[ 4, 4, 1, 1, 1, 1, 10, 10, 10, 1, 10, 24, 1, 10, 1, 10 ],
	[ 11, 10, 11, 10, 1, 1, 1, 1, 1, 1, 24, 10, 24, 24, 1, 1 ],
	[ 11, 10, 1, 23, 10, 10, 1, 10, 1, 24, 1, 10, 10, 1, 10, 10 ],
	[ 1, 1, 10, 10, 1, 10, 1, 1, 1, 1, 1, 1, 1, 1, 10, 1 ],
	[ 24, 1, 10, 1, 1, 1, 10, 10, 1, 10, 10, 1, 1, 10, 10, 24 ],
	[ 1, 24, 10, 1, 10, 1, 1, 22, 10, 10, 1, 1, 10, 1, 24, 10 ],
	[ 1, 1, 10, 10, 1, 10, 1, 10, 24, 1, 10, 10, 24, 23, 1, 1 ],
	[ 10, 10, 1, 1, 1, 1, 24, 10, 10, 1, 10, 1, 10, 10, 10, 1 ],
	[ 1, 1, 1, 10, 10, 1, 1, 10, 1, 10, 10, 10, 1, 1, 1, 10 ],
	[ 1, 1, 10, 10, 10, 24, 10, 1, 10, 1, 10, 1, 24, 10, 1, 1 ],
	[ 1, 24, 24, 10, 1, 1, 1, 1, 24, 1, 1, 1, 10, 1, 1, 10 ],
	[ 24, 24, 1, 10, 1, 1, 10, 10, 24, 1, 10, 1, 1, 1, 10, 10 ],
	[ 1, 24, 10, 1, 1, 10, 10, 1, 1, 10, 10, 1, 1, 22, 22, 10 ],
	[ 10, 22, 1, 1, 1, 24, 1, 10, 1, 1, 1, 1, 10, 10, 10, 10 ],
	[ 1, 10, 1, 1, 24, 10, 10, 1, 1, 1, 1, 10, 22, 10, 1, 1 ]
],
"objects": [
	{
		"class": "io.github.pokemeetup.system.gameplay.overworld.World$WorldObjectData",
		"x": -13088,
		"y": 992,
		"type": "POKEBALL"
	}
],
"blocks": [],
"lastModified": 0,
"isMultiplayer": false
}