{
"x": -79,
"y": -18,
"biomeType": "HAUNTED",
"tileData": [
	[ 4, 51, 51, 4, 4, 4, 4, 4, 6, 51, 4, 4, 4, 4, 4, 4 ],
	[ 4, 4, 4, 4, 5, 5, 7, 5, 9, 5, 7, 5, 5, 4, 4, 52 ],
	[ 1, 5, 8, 5, 5, 9, 7, 9, 7, 5, 5, 5, 7, 5, 5, 6 ],
	[ 7, 7, 5, 5, 7, 7, 7, 5, 5, 5, 5, 5, 7, 7, 9, 9 ],
	[ 5, 5, 5, 5, 9, 9, 5, 5, 7, 5, 7, 7, 5, 5, 7, 5 ],
	[ 5, 7, 5, 5, 7, 1, 7, 5, 5, 5, 5, 5, 5, 10, 7, 5 ],
	[ 5, 7, 9, 8, 5, 7, 7, 5, 9, 8, 7, 9, 5, 5, 5, 5 ],
	[ 7, 9, 5, 7, 7, 5, 5, 5, 5, 9, 5, 5, 5, 5, 5, 7 ],
	[ 5, 5, 7, 5, 5, 5, 5, 7, 7, 5, 7, 8, 5, 7, 5, 5 ],
	[ 7, 5, 5, 7, 5, 5, 7, 5, 5, 5, 5, 5, 5, 5, 1, 5 ],
	[ 7, 10, 5, 5, 9, 5, 5, 7, 7, 7, 5, 5, 7, 7, 5, 7 ],
	[ 5, 5, 5, 5, 5, 9, 7, 7, 5, 5, 5, 8, 5, 7, 5, 5 ],
	[ 7, 5, 5, 7, 5, 8, 7, 7, 5, 8, 9, 7, 5, 7, 7, 5 ],
	[ 5, 7, 5, 5, 5, 7, 7, 5, 9, 7, 5, 5, 1, 9, 5, 5 ],
	[ 5, 5, 5, 8, 7, 5, 7, 5, 5, 5, 7, 7, 5, 5, 7, 9 ],
	[ 5, 5, 5, 5, 7, 5, 9, 7, 7, 5, 9, 7, 5, 7, 7, 7 ]
],
"objects": [
	{
		"class": "io.github.pokemeetup.system.gameplay.overworld.World$WorldObjectData",
		"x": -40448,
		"y": -8896,
		"type": "SNOW_TREE"
	},
	{
		"class": "io.github.pokemeetup.system.gameplay.overworld.World$WorldObjectData",
		"x": -40288,
		"y": -9056,
		"type": "POKEBALL"
	}
],
"blocks": [],
"lastModified": 0,
"isMultiplayer": false
}