{
"x": -25,
"y": -3,
"biomeType": "PLAINS",
"tileData": [
	[ 11, 11, 4, 4, 11, 11, 4, 6, 12, 4, 11, 1, 1, 4, 51, 4 ],
	[ 51, 52, 4, 4, 4, 4, 51, 4, 6, 4, 4, 4, 4, 12, 4, 4 ],
	[ 11, 11, 1, 11, 11, 1, 12, 11, 11, 12, 12, 11, 12, 1, 11, 11 ],
	[ 11, 11, 10, 11, 10, 10, 11, 1, 10, 10, 1, 1, 12, 11, 10, 1 ],
	[ 1, 10, 1, 1, 10, 1, 1, 10, 12, 1, 12, 11, 1, 11, 1, 10 ],
	[ 10, 22, 22, 24, 1, 1, 24, 10, 1, 10, 10, 1, 1, 10, 1, 1 ],
	[ 1, 10, 10, 1, 1, 10, 1, 1, 1, 10, 1, 1, 1, 10, 10, 1 ],
	[ 10, 5, 1, 5, 5, 7, 5, 24, 10, 5, 10, 8, 5, 1, 5, 9 ],
	[ 1, 10, 1, 5, 7, 1, 7, 7, 1, 7, 1, 5, 1, 24, 5, 1 ],
	[ 5, 5, 5, 1, 5, 1, 7, 5, 5, 7, 7, 5, 7, 5, 5, 7 ],
	[ 5, 5, 7, 5, 5, 5, 5, 7, 8, 5, 7, 5, 5, 5, 7, 5 ],
	[ 7, 5, 8, 10, 7, 5, 5, 7, 8, 7, 8, 7, 5, 7, 7, 7 ],
	[ 5, 5, 7, 7, 5, 5, 8, 5, 5, 5, 7, 7, 5, 8, 5, 5 ],
	[ 9, 1, 9, 5, 7, 5, 5, 9, 7, 7, 5, 5, 9, 5, 5, 9 ],
	[ 5, 5, 5, 5, 5, 5, 5, 1, 7, 5, 5, 5, 5, 10, 8, 7 ],
	[ 1, 1, 1, 7, 7, 5, 7, 8, 8, 5, 7, 5, 5, 8, 5, 5 ]
],
"objects": [
	{
		"class": "io.github.pokemeetup.system.gameplay.overworld.World$WorldObjectData",
		"x": -12768,
		"y": -1344,
		"type": "SNOW_TREE"
	},
	{
		"class": "io.github.pokemeetup.system.gameplay.overworld.World$WorldObjectData",
		"x": -12352,
		"y": -1312,
		"type": "POKEBALL"
	}
],
"blocks": [],
"lastModified": 0,
"isMultiplayer": false
}