{
"x": -38,
"y": -12,
"biomeType": "FOREST",
"tileData": [
	[ 4, 4, 52, 6, 4, 4, 4, 1, 1, 11, 12, 1, 11, 12, 12, 11 ],
	[ 4, 6, 11, 6, 4, 4, 10, 1, 12, 11, 12, 11, 11, 11, 11, 10 ],
	[ 4, 4, 12, 4, 4, 11, 1, 1, 11, 12, 1, 11, 11, 12, 10, 12 ],
	[ 6, 12, 1, 4, 20, 11, 11, 11, 11, 11, 11, 12, 1, 10, 11, 12 ],
	[ 12, 11, 11, 12, 1, 12, 11, 12, 11, 11, 12, 11, 11, 11, 12, 11 ],
	[ 11, 11, 11, 12, 11, 12, 11, 11, 11, 11, 12, 10, 12, 1, 12, 11 ],
	[ 11, 20, 12, 11, 11, 1, 11, 12, 11, 11, 1, 11, 11, 11, 11, 11 ],
	[ 11, 11, 1, 12, 11, 10, 11, 11, 11, 1, 12, 11, 12, 11, 11, 11 ],
	[ 11, 12, 10, 12, 1, 11, 1, 12, 11, 11, 12, 12, 11, 12, 1, 12 ],
	[ 11, 1, 10, 11, 11, 10, 12, 12, 11, 12, 12, 11, 11, 12, 10, 11 ],
	[ 1, 12, 12, 11, 11, 11, 12, 1, 11, 12, 11, 1, 11, 10, 11, 11 ],
	[ 12, 10, 11, 20, 1, 11, 11, 10, 11, 11, 11, 11, 1, 20, 11, 11 ],
	[ 11, 12, 11, 12, 10, 11, 1, 11, 11, 12, 12, 11, 11, 10, 12, 11 ],
	[ 11, 1, 11, 12, 11, 12, 11, 11, 11, 11, 12, 11, 12, 1, 11, 11 ],
	[ 10, 11, 11, 12, 11, 1, 11, 11, 12, 11, 11, 1, 11, 11, 10, 1 ],
	[ 12, 11, 11, 1, 11, 11, 11, 11, 11, 1, 1, 11, 11, 11, 12, 12 ]
],
"objects": [
	{
		"class": "io.github.pokemeetup.system.gameplay.overworld.World$WorldObjectData",
		"x": -19392,
		"y": -5952,
		"type": "POKEBALL"
	}
],
"blocks": [],
"lastModified": 0,
"isMultiplayer": false
}