{
"x": -79,
"y": -19,
"biomeType": "HAUNTED",
"tileData": [
	[ 4, 4, 4, 4, 4, 4, 6, 4, 4, 4, 51, 4, 4, 51, 4, 4 ],
	[ 4, 4, 4, 4, 6, 6, 4, 4, 4, 4, 51, 4, 6, 4, 4, 4 ],
	[ 4, 51, 4, 51, 4, 4, 4, 51, 4, 4, 52, 4, 4, 4, 5, 7 ],
	[ 8, 5, 9, 5, 5, 8, 5, 5, 5, 10, 7, 5, 7, 5, 7, 5 ],
	[ 9, 5, 9, 5, 5, 5, 7, 7, 5, 7, 5, 5, 5, 7, 5, 5 ],
	[ 5, 7, 8, 5, 5, 10, 7, 5, 7, 5, 5, 5, 5, 5, 5, 7 ],
	[ 9, 9, 5, 5, 7, 5, 8, 8, 7, 5, 5, 5, 1, 8, 8, 5 ],
	[ 9, 5, 5, 5, 5, 8, 5, 5, 5, 7, 9, 5, 5, 5, 8, 5 ],
	[ 5, 5, 5, 5, 7, 5, 9, 5, 7, 7, 5, 5, 5, 5, 7, 5 ],
	[ 5, 1, 5, 5, 1, 5, 5, 5, 5, 7, 5, 1, 5, 5, 7, 5 ],
	[ 5, 9, 5, 8, 5, 5, 7, 5, 8, 5, 5, 5, 5, 5, 9, 7 ],
	[ 1, 5, 7, 7, 7, 5, 5, 5, 5, 5, 5, 5, 5, 1, 5, 7 ],
	[ 5, 5, 7, 5, 7, 7, 5, 9, 5, 5, 5, 5, 8, 7, 5, 5 ],
	[ 9, 5, 5, 5, 8, 10, 7, 5, 5, 5, 5, 5, 5, 7, 7, 5 ],
	[ 7, 9, 7, 7, 5, 5, 5, 5, 5, 5, 5, 8, 7, 7, 5, 5 ],
	[ 5, 5, 5, 5, 5, 5, 7, 5, 9, 7, 5, 5, 8, 5, 5, 5 ]
],
"objects": [
	{
		"class": "io.github.pokemeetup.system.gameplay.overworld.World$WorldObjectData",
		"x": -40416,
		"y": -9536,
		"type": "SNOW_TREE"
	},
	{
		"class": "io.github.pokemeetup.system.gameplay.overworld.World$WorldObjectData",
		"x": -40384,
		"y": -9376,
		"type": "SNOW_TREE"
	},
	{
		"class": "io.github.pokemeetup.system.gameplay.overworld.World$WorldObjectData",
		"x": -40160,
		"y": -9696,
		"type": "POKEBALL"
	}
],
"blocks": [],
"lastModified": 0,
"isMultiplayer": false
}