{
"x": -93,
"y": -7,
"biomeType": "HAUNTED",
"tileData": [
	[ 16, 15, 15, 17, 7, 5, 5, 5, 5, 5, 9, 5, 5, 5, 9, 5 ],
	[ 2, 15, 15, 15, 5, 7, 7, 5, 5, 5, 5, 5, 5, 5, 5, 8 ],
	[ 15, 16, 15, 15, 5, 7, 7, 5, 7, 5, 5, 5, 7, 7, 8, 7 ],
	[ 15, 15, 15, 15, 8, 7, 5, 8, 5, 5, 5, 1, 5, 5, 5, 9 ],
	[ 1, 15, 2, 15, 5, 5, 7, 5, 5, 5, 7, 7, 5, 5, 7, 5 ],
	[ 10, 1, 15, 17, 7, 9, 5, 5, 5, 7, 7, 7, 7, 5, 5, 5 ],
	[ 1, 24, 15, 2, 15, 7, 5, 7, 7, 8, 5, 5, 7, 5, 5, 5 ],
	[ 22, 1, 1, 17, 15, 5, 5, 8, 8, 7, 8, 5, 5, 5, 5, 7 ],
	[ 1, 1, 10, 17, 15, 5, 7, 5, 5, 9, 5, 5, 5, 7, 5, 7 ],
	[ 10, 24, 24, 1, 15, 8, 7, 5, 7, 7, 5, 7, 9, 5, 5, 5 ],
	[ 1, 10, 1, 1, 1, 5, 5, 7, 5, 5, 7, 5, 8, 7, 5, 9 ],
	[ 10, 10, 10, 10, 5, 15, 7, 9, 5, 5, 5, 5, 5, 5, 5, 5 ],
	[ 1, 10, 1, 10, 7, 1, 7, 5, 5, 8, 9, 5, 7, 9, 5, 5 ],
	[ 1, 24, 10, 1, 24, 9, 5, 5, 8, 5, 5, 5, 5, 7, 7, 5 ],
	[ 24, 24, 10, 1, 1, 1, 5, 7, 8, 7, 5, 9, 5, 7, 7, 5 ],
	[ 1, 24, 1, 10, 1, 10, 5, 5, 5, 5, 5, 7, 5, 7, 7, 5 ]
],
"objects": [
	{
		"class": "io.github.pokemeetup.system.gameplay.overworld.World$WorldObjectData",
		"x": -47520,
		"y": -3552,
		"type": "CACTUS"
	},
	{
		"class": "io.github.pokemeetup.system.gameplay.overworld.World$WorldObjectData",
		"x": -47392,
		"y": -3456,
		"type": "CACTUS"
	},
	{
		"class": "io.github.pokemeetup.system.gameplay.overworld.World$WorldObjectData",
		"x": -47200,
		"y": -3584,
		"type": "POKEBALL"
	}
],
"blocks": [],
"lastModified": 0,
"isMultiplayer": false
}