{
"x": -121,
"y": -9,
"biomeType": "HAUNTED",
"tileData": [
	[ 6, 4, 6, 51, 4, 4, 52, 6, 4, 4, 4, 4, 4, 4, 11, 11 ],
	[ 51, 51, 4, 4, 4, 4, 4, 4, 6, 6, 4, 4, 12, 51, 10, 10 ],
	[ 5, 7, 5, 5, 5, 8, 5, 8, 7, 5, 5, 1, 9, 8, 20, 11 ],
	[ 5, 7, 5, 7, 7, 5, 5, 8, 5, 5, 9, 8, 7, 5, 1, 11 ],
	[ 5, 5, 5, 1, 5, 7, 5, 5, 5, 5, 8, 5, 7, 5, 11, 11 ],
	[ 5, 10, 5, 5, 5, 5, 9, 5, 5, 5, 9, 5, 7, 5, 11, 11 ],
	[ 7, 5, 7, 7, 8, 5, 5, 5, 7, 5, 10, 8, 5, 5, 10, 1 ],
	[ 9, 5, 8, 7, 5, 5, 7, 9, 8, 7, 8, 5, 5, 11, 10, 11 ],
	[ 9, 7, 9, 5, 5, 10, 7, 5, 5, 7, 5, 5, 10, 7, 11, 11 ],
	[ 5, 5, 5, 5, 10, 7, 7, 7, 7, 5, 5, 5, 11, 11, 11, 11 ],
	[ 5, 5, 5, 9, 9, 5, 7, 5, 5, 5, 5, 5, 5, 11, 11, 11 ],
	[ 5, 5, 10, 5, 8, 9, 7, 5, 5, 5, 5, 5, 5, 11, 11, 11 ],
	[ 5, 5, 7, 8, 7, 7, 5, 5, 7, 5, 5, 5, 5, 11, 11, 1 ],
	[ 5, 1, 5, 7, 5, 5, 5, 5, 10, 5, 11, 5, 11, 11, 12, 11 ],
	[ 7, 5, 8, 7, 5, 7, 5, 7, 5, 7, 7, 5, 11, 11, 1, 10 ],
	[ 5, 9, 8, 5, 5, 9, 5, 5, 9, 12, 5, 5, 10, 11, 11, 1 ]
],
"objects": [
	{
		"class": "io.github.pokemeetup.system.gameplay.overworld.World$WorldObjectData",
		"x": -61920,
		"y": -4416,
		"type": "SNOW_TREE"
	},
	{
		"class": "io.github.pokemeetup.system.gameplay.overworld.World$WorldObjectData",
		"x": -61952,
		"y": -4288,
		"type": "SNOW_TREE"
	},
	{
		"class": "io.github.pokemeetup.system.gameplay.overworld.World$WorldObjectData",
		"x": -61760,
		"y": -4128,
		"type": "POKEBALL"
	}
],
"blocks": [],
"lastModified": 0,
"isMultiplayer": false
}