{
"x": -105,
"y": -7,
"biomeType": "SNOW",
"tileData": [
	[ 11, 11, 11, 11, 51, 6, 4, 4, 4, 4, 4, 4, 52, 4, 4, 4 ],
	[ 11, 11, 12, 11, 6, 4, 51, 4, 4, 4, 4, 4, 4, 6, 4, 6 ],
	[ 12, 20, 1, 4, 4, 6, 6, 4, 4, 4, 4, 4, 4, 4, 4, 4 ],
	[ 11, 12, 51, 4, 51, 4, 4, 51, 4, 4, 4, 4, 4, 4, 52, 4 ],
	[ 11, 12, 4, 4, 4, 4, 4, 4, 6, 4, 4, 4, 4, 4, 51, 6 ],
	[ 20, 4, 4, 4, 4, 4, 51, 4, 4, 4, 4, 4, 4, 4, 4, 51 ],
	[ 4, 4, 4, 4, 52, 4, 4, 4, 4, 4, 4, 4, 4, 4, 4, 4 ],
	[ 51, 4, 4, 4, 4, 4, 4, 6, 4, 4, 4, 4, 4, 4, 4, 4 ],
	[ 4, 4, 4, 4, 51, 4, 4, 4, 4, 4, 4, 4, 4, 51, 51, 4 ],
	[ 6, 4, 4, 4, 4, 6, 4, 4, 4, 4, 4, 4, 4, 4, 4, 4 ],
	[ 51, 51, 4, 4, 4, 4, 4, 4, 51, 4, 51, 6, 4, 4, 4, 4 ],
	[ 4, 4, 4, 4, 4, 4, 4, 4, 51, 4, 51, 4, 4, 6, 4, 4 ],
	[ 4, 4, 4, 4, 4, 6, 4, 4, 4, 4, 4, 4, 6, 4, 4, 4 ],
	[ 4, 4, 4, 4, 4, 4, 4, 4, 4, 4, 4, 4, 51, 4, 4, 6 ],
	[ 4, 4, 4, 4, 4, 51, 4, 51, 51, 4, 4, 4, 4, 4, 51, 4 ],
	[ 4, 4, 4, 4, 6, 4, 51, 4, 4, 6, 4, 51, 6, 6, 4, 4 ]
],
"objects": [
	{
		"class": "io.github.pokemeetup.system.gameplay.overworld.World$WorldObjectData",
		"x": -53664,
		"y": -3552,
		"type": "TREE_0"
	},
	{
		"class": "io.github.pokemeetup.system.gameplay.overworld.World$WorldObjectData",
		"x": -53760,
		"y": -3552,
		"type": "TREE_1"
	}
],
"blocks": [],
"lastModified": 0,
"isMultiplayer": false
}