{
"x": -25,
"y": -2,
"biomeType": "PLAINS",
"tileData": [
	[ 4, 52, 12, 12, 51, 12, 11, 4, 4, 11, 4, 4, 1, 11, 4, 11 ],
	[ 11, 12, 6, 4, 4, 1, 4, 11, 4, 11, 12, 1, 12, 11, 11, 12 ],
	[ 12, 11, 11, 12, 12, 11, 11, 12, 11, 12, 10, 11, 1, 11, 1, 12 ],
	[ 1, 10, 1, 10, 11, 1, 12, 1, 12, 1, 12, 11, 12, 11, 10, 11 ],
	[ 11, 10, 10, 11, 10, 12, 12, 1, 22, 10, 11, 11, 11, 1, 10, 1 ],
	[ 1, 1, 1, 1, 10, 1, 24, 10, 1, 10, 1, 1, 23, 10, 10, 1 ],
	[ 10, 1, 10, 1, 1, 1, 24, 1, 1, 1, 1, 5, 1, 10, 1, 1 ],
	[ 1, 1, 10, 10, 8, 8, 1, 5, 1, 5, 5, 5, 10, 1, 5, 5 ],
	[ 5, 7, 10, 5, 7, 9, 5, 10, 1, 5, 7, 5, 9, 5, 5, 8 ],
	[ 5, 5, 7, 8, 9, 9, 7, 8, 5, 7, 9, 5, 7, 7, 7, 5 ],
	[ 5, 8, 9, 9, 5, 5, 7, 5, 8, 7, 5, 5, 5, 8, 5, 5 ],
	[ 9, 7, 9, 5, 5, 8, 9, 5, 7, 7, 5, 5, 8, 5, 5, 7 ],
	[ 5, 5, 7, 5, 7, 1, 5, 8, 9, 5, 5, 9, 7, 7, 7, 7 ],
	[ 5, 8, 5, 5, 10, 7, 8, 5, 5, 5, 8, 7, 5, 7, 7, 5 ],
	[ 5, 5, 7, 5, 5, 7, 9, 5, 5, 7, 5, 7, 8, 7, 5, 5 ],
	[ 5, 5, 5, 8, 8, 7, 7, 7, 7, 5, 5, 8, 5, 5, 5, 5 ]
],
"objects": [
	{
		"class": "io.github.pokemeetup.system.gameplay.overworld.World$WorldObjectData",
		"x": -12768,
		"y": -832,
		"type": "SNOW_TREE"
	},
	{
		"class": "io.github.pokemeetup.system.gameplay.overworld.World$WorldObjectData",
		"x": -12800,
		"y": -704,
		"type": "SNOW_TREE"
	},
	{
		"class": "io.github.pokemeetup.system.gameplay.overworld.World$WorldObjectData",
		"x": -12608,
		"y": -992,
		"type": "POKEBALL"
	}
],
"blocks": [],
"lastModified": 0,
"isMultiplayer": false
}