{
"x": -74,
"y": -18,
"biomeType": "PLAINS",
"tileData": [
	[ 12, 12, 4, 4, 11, 11, 11, 20, 1, 11, 10, 1, 1, 10, 1, 1 ],
	[ 4, 4, 4, 11, 11, 11, 22, 12, 11, 1, 10, 10, 1, 22, 1, 1 ],
	[ 52, 11, 12, 11, 1, 12, 12, 11, 1, 10, 10, 10, 10, 1, 1, 10 ],
	[ 11, 11, 12, 11, 11, 10, 11, 11, 10, 10, 1, 10, 24, 1, 1, 10 ],
	[ 12, 1, 12, 12, 1, 1, 1, 1, 10, 1, 1, 10, 1, 10, 1, 24 ],
	[ 11, 11, 10, 11, 10, 11, 10, 1, 10, 1, 24, 1, 1, 1, 1, 1 ],
	[ 12, 11, 1, 11, 11, 10, 10, 10, 24, 10, 1, 1, 1, 10, 10, 10 ],
	[ 1, 12, 11, 11, 1, 10, 1, 24, 1, 1, 1, 10, 10, 1, 10, 1 ],
	[ 10, 11, 12, 24, 1, 10, 10, 1, 10, 1, 10, 10, 24, 10, 10, 1 ],
	[ 11, 11, 11, 23, 1, 24, 10, 1, 1, 10, 1, 1, 1, 10, 1, 1 ],
	[ 10, 1, 1, 10, 10, 1, 10, 1, 10, 10, 10, 1, 10, 1, 1, 24 ],
	[ 10, 10, 1, 10, 1, 1, 10, 1, 1, 1, 24, 1, 1, 1, 10, 1 ],
	[ 22, 1, 10, 1, 10, 1, 1, 24, 10, 10, 1, 10, 1, 1, 1, 1 ],
	[ 10, 10, 10, 1, 1, 10, 22, 1, 1, 10, 1, 1, 10, 10, 1, 1 ],
	[ 10, 1, 1, 10, 1, 1, 24, 10, 1, 1, 5, 24, 5, 7, 10, 5 ],
	[ 24, 1, 1, 10, 24, 1, 24, 10, 1, 10, 10, 7, 5, 1, 1, 1 ]
],
"objects": [
	{
		"class": "io.github.pokemeetup.system.gameplay.overworld.World$WorldObjectData",
		"x": -37472,
		"y": -9088,
		"type": "POKEBALL"
	}
],
"blocks": [],
"lastModified": 0,
"isMultiplayer": false
}