{
"x": -75,
"y": -10,
"biomeType": "HAUNTED",
"tileData": [
	[ 4, 4, 5, 5, 5, 5, 5, 5, 5, 5, 5, 9, 8, 9, 5, 5 ],
	[ 4, 5, 9, 8, 5, 5, 5, 5, 5, 7, 7, 1, 5, 5, 5, 5 ],
	[ 4, 7, 5, 1, 5, 5, 5, 5, 5, 8, 5, 5, 10, 5, 5, 7 ],
	[ 9, 7, 5, 7, 7, 9, 5, 7, 5, 5, 5, 7, 5, 5, 5, 7 ],
	[ 9, 5, 5, 1, 5, 5, 9, 5, 5, 5, 5, 5, 5, 5, 8, 5 ],
	[ 5, 5, 7, 5, 7, 7, 5, 5, 5, 7, 9, 5, 5, 7, 7, 5 ],
	[ 7, 5, 7, 5, 9, 7, 5, 7, 5, 5, 5, 5, 7, 7, 7, 5 ],
	[ 7, 5, 5, 5, 5, 7, 5, 5, 5, 5, 7, 8, 5, 9, 5, 5 ],
	[ 9, 5, 5, 5, 5, 9, 1, 5, 5, 5, 8, 8, 9, 5, 7, 5 ],
	[ 5, 7, 5, 7, 7, 9, 5, 5, 5, 5, 5, 7, 9, 5, 5, 5 ],
	[ 5, 5, 8, 7, 5, 5, 7, 7, 5, 5, 9, 5, 5, 5, 7, 7 ],
	[ 7, 10, 5, 5, 5, 9, 9, 8, 5, 5, 7, 5, 5, 7, 9, 5 ],
	[ 5, 5, 7, 5, 5, 5, 5, 7, 7, 7, 5, 5, 9, 7, 5, 5 ],
	[ 7, 7, 5, 5, 7, 7, 5, 9, 5, 5, 7, 9, 7, 1, 7, 7 ],
	[ 7, 5, 5, 9, 5, 5, 9, 7, 5, 7, 5, 7, 7, 9, 5, 5 ],
	[ 7, 5, 5, 5, 5, 7, 8, 7, 5, 5, 5, 5, 9, 9, 7, 5 ]
],
"objects": [
	{
		"class": "io.github.pokemeetup.system.gameplay.overworld.World$WorldObjectData",
		"x": -37984,
		"y": -4704,
		"type": "POKEBALL"
	}
],
"blocks": [],
"lastModified": 0,
"isMultiplayer": false
}