{
"x": -122,
"y": -24,
"biomeType": "SNOW",
"tileData": [
	[ 4, 4, 6, 4, 4, 6, 51, 206, 203, 203, 203, 203, 200, 23, 10, 1 ],
	[ 6, 4, 4, 4, 4, 4, 206, 204, 204, 206, 200, 204, 204, 200, 1, 1 ],
	[ 4, 4, 4, 51, 206, 203, 204, 204, 206, 204, 204, 200, 204, 204, 200, 1 ],
	[ 4, 4, 4, 206, 204, 204, 204, 204, 207, 204, 204, 204, 200, 204, 204, 200 ],
	[ 4, 6, 206, 204, 204, 204, 204, 206, 204, 204, 204, 204, 204, 200, 204, 201 ],
	[ 206, 203, 204, 204, 204, 206, 203, 204, 204, 204, 204, 204, 204, 201, 204, 201 ],
	[ 207, 204, 204, 206, 203, 204, 204, 204, 204, 204, 204, 204, 204, 204, 200, 201 ],
	[ 207, 204, 206, 204, 204, 204, 206, 203, 200, 235, 204, 204, 204, 204, 201, 201 ],
	[ 207, 206, 204, 204, 206, 203, 204, 204, 201, 204, 207, 204, 204, 204, 201, 201 ],
	[ 207, 207, 204, 206, 204, 204, 204, 204, 201, 203, 204, 204, 204, 204, 201, 201 ],
	[ 207, 208, 204, 208, 204, 204, 204, 204, 202, 204, 204, 204, 204, 204, 202, 201 ],
	[ 207, 204, 207, 204, 208, 205, 205, 202, 204, 204, 204, 205, 205, 202, 204, 201 ],
	[ 208, 204, 208, 204, 204, 204, 204, 204, 205, 205, 202, 204, 204, 204, 204, 201 ],
	[ 5, 208, 204, 208, 205, 205, 205, 202, 204, 204, 204, 204, 204, 204, 204, 201 ],
	[ 1, 5, 208, 235, 204, 204, 204, 235, 205, 205, 205, 205, 205, 205, 205, 202 ],
	[ 7, 7, 5, 7, 208, 205, 202, 8, 5, 5, 10, 24, 1, 4, 51, 52 ]
],
"objects": [
	{
		"class": "io.github.pokemeetup.system.gameplay.overworld.World$WorldObjectData",
		"x": -62400,
		"y": -12256,
		"type": "SNOW_TREE"
	},
	{
		"class": "io.github.pokemeetup.system.gameplay.overworld.World$WorldObjectData",
		"x": -62464,
		"y": -12160,
		"type": "SNOW_TREE"
	},
	{
		"class": "io.github.pokemeetup.system.gameplay.overworld.World$WorldObjectData",
		"x": -61984,
		"y": -11904,
		"type": "POKEBALL"
	}
],
"blocks": [],
"lastModified": 0,
"isMultiplayer": false
}