{
"x": -127,
"y": -28,
"biomeType": "SNOW",
"tileData": [
	[ 4, 4, 4, 4, 4, 4, 6, 4, 4, 4, 4, 4, 4, 51, 4, 4 ],
	[ 4, 51, 6, 4, 6, 6, 4, 4, 4, 4, 6, 4, 4, 4, 4, 4 ],
	[ 4, 4, 4, 6, 6, 4, 4, 206, 203, 203, 203, 203, 200, 4, 51, 4 ],
	[ 6, 4, 4, 4, 4, 4, 4, 207, 204, 204, 204, 204, 204, 203, 203, 200 ],
	[ 4, 4, 206, 203, 203, 203, 203, 204, 204, 204, 206, 203, 200, 204, 204, 201 ],
	[ 4, 206, 204, 204, 204, 204, 204, 204, 204, 206, 204, 204, 204, 200, 204, 201 ],
	[ 206, 204, 204, 204, 206, 200, 204, 204, 206, 204, 204, 204, 204, 204, 200, 201 ],
	[ 207, 204, 206, 203, 204, 204, 203, 203, 204, 204, 204, 204, 204, 204, 204, 200 ],
	[ 206, 203, 204, 204, 204, 204, 204, 204, 204, 204, 204, 204, 204, 204, 204, 201 ],
	[ 207, 204, 204, 204, 204, 204, 204, 204, 204, 204, 204, 204, 204, 204, 204, 201 ],
	[ 208, 204, 204, 204, 206, 200, 204, 204, 204, 204, 204, 204, 204, 204, 204, 201 ],
	[ 207, 207, 204, 206, 204, 204, 200, 204, 204, 204, 204, 204, 204, 204, 204, 201 ],
	[ 207, 207, 204, 208, 204, 204, 202, 204, 204, 204, 204, 204, 204, 204, 204, 202 ],
	[ 207, 207, 204, 204, 208, 202, 204, 204, 204, 204, 205, 205, 205, 205, 202, 201 ],
	[ 207, 208, 204, 204, 204, 204, 204, 204, 204, 202, 204, 204, 204, 204, 204, 201 ],
	[ 208, 205, 208, 205, 205, 205, 205, 205, 202, 205, 205, 205, 205, 205, 205, 202 ]
],
"objects": [
	{
		"class": "io.github.pokemeetup.system.gameplay.overworld.World$WorldObjectData",
		"x": -65024,
		"y": -13984,
		"type": "SNOW_TREE"
	},
	{
		"class": "io.github.pokemeetup.system.gameplay.overworld.World$WorldObjectData",
		"x": -64928,
		"y": -14144,
		"type": "SNOW_TREE"
	},
	{
		"class": "io.github.pokemeetup.system.gameplay.overworld.World$WorldObjectData",
		"x": -64960,
		"y": -14304,
		"type": "SNOW_TREE"
	},
	{
		"class": "io.github.pokemeetup.system.gameplay.overworld.World$WorldObjectData",
		"x": -64864,
		"y": -14336,
		"type": "SNOW_TREE"
	},
	{
		"class": "io.github.pokemeetup.system.gameplay.overworld.World$WorldObjectData",
		"x": -65024,
		"y": -14208,
		"type": "SNOW_TREE"
	}
],
"blocks": [],
"lastModified": 0,
"isMultiplayer": false
}