{
"x": -125,
"y": -31,
"biomeType": "SNOW",
"tileData": [
	[ 206, 203, 203, 203, 203, 206, 203, 203, 203, 200, 203, 203, 200, 4, 4, 6 ],
	[ 207, 204, 204, 204, 206, 204, 204, 204, 204, 204, 200, 204, 201, 4, 51, 4 ],
	[ 207, 204, 204, 206, 204, 204, 204, 204, 204, 204, 204, 200, 235, 4, 4, 4 ],
	[ 207, 204, 206, 204, 204, 204, 206, 203, 200, 204, 204, 201, 201, 4, 51, 4 ],
	[ 207, 206, 204, 204, 204, 206, 204, 204, 204, 200, 204, 201, 201, 52, 4, 4 ],
	[ 207, 207, 204, 204, 204, 207, 204, 204, 204, 201, 204, 201, 201, 4, 4, 4 ],
	[ 207, 208, 204, 204, 204, 208, 204, 204, 204, 202, 204, 201, 235, 6, 4, 4 ],
	[ 207, 204, 208, 204, 204, 204, 208, 205, 202, 204, 204, 202, 201, 4, 4, 4 ],
	[ 207, 204, 204, 208, 204, 204, 204, 204, 204, 205, 202, 204, 202, 4, 4, 4 ],
	[ 208, 204, 204, 204, 208, 205, 205, 205, 202, 204, 205, 202, 4, 4, 4, 4 ],
	[ 4, 207, 204, 204, 204, 204, 204, 204, 205, 202, 4, 6, 4, 4, 4, 6 ],
	[ 4, 208, 205, 205, 205, 205, 205, 202, 51, 52, 4, 4, 4, 4, 4, 4 ],
	[ 4, 4, 51, 4, 6, 4, 4, 51, 6, 6, 51, 4, 4, 4, 6, 4 ],
	[ 4, 4, 4, 4, 51, 4, 4, 51, 4, 6, 4, 4, 4, 51, 4, 4 ],
	[ 4, 6, 4, 4, 4, 4, 51, 51, 4, 4, 4, 4, 52, 4, 4, 4 ],
	[ 51, 6, 52, 4, 6, 51, 4, 51, 4, 4, 52, 52, 52, 51, 4, 4 ]
],
"objects": [
	{
		"class": "io.github.pokemeetup.system.gameplay.overworld.World$WorldObjectData",
		"x": -63584,
		"y": -15520,
		"type": "SNOW_TREE"
	},
	{
		"class": "io.github.pokemeetup.system.gameplay.overworld.World$WorldObjectData",
		"x": -63616,
		"y": -15840,
		"type": "SNOW_TREE"
	},
	{
		"class": "io.github.pokemeetup.system.gameplay.overworld.World$WorldObjectData",
		"x": -63552,
		"y": -15616,
		"type": "SNOW_TREE"
	},
	{
		"class": "io.github.pokemeetup.system.gameplay.overworld.World$WorldObjectData",
		"x": -63584,
		"y": -15392,
		"type": "SNOW_TREE"
	},
	{
		"class": "io.github.pokemeetup.system.gameplay.overworld.World$WorldObjectData",
		"x": -63808,
		"y": -15392,
		"type": "SNOW_TREE"
	}
],
"blocks": [],
"lastModified": 0,
"isMultiplayer": false
}