{
"x": -125,
"y": -47,
"biomeType": "SNOW",
"tileData": [
	[ 4, 4, 4, 4, 4, 206, 203, 203, 203, 203, 203, 203, 203, 203, 203, 200 ],
	[ 4, 4, 206, 203, 203, 204, 204, 204, 206, 203, 203, 200, 204, 204, 204, 201 ],
	[ 4, 206, 204, 204, 204, 206, 203, 203, 204, 204, 204, 204, 200, 204, 204, 201 ],
	[ 206, 204, 204, 206, 203, 204, 204, 204, 204, 204, 204, 204, 201, 204, 204, 201 ],
	[ 207, 204, 206, 204, 204, 204, 204, 204, 204, 204, 204, 204, 201, 204, 204, 201 ],
	[ 207, 206, 204, 204, 204, 204, 204, 204, 204, 204, 204, 204, 201, 204, 204, 201 ],
	[ 206, 204, 204, 204, 204, 201, 204, 204, 204, 204, 204, 204, 204, 200, 204, 201 ],
	[ 208, 204, 204, 204, 204, 204, 204, 204, 204, 204, 204, 204, 204, 201, 204, 201 ],
	[ 207, 208, 204, 204, 204, 204, 204, 204, 204, 204, 204, 204, 204, 201, 204, 201 ],
	[ 207, 204, 208, 204, 204, 204, 204, 204, 204, 204, 204, 204, 204, 201, 204, 201 ],
	[ 208, 204, 204, 207, 204, 204, 204, 204, 204, 204, 204, 204, 204, 202, 204, 201 ],
	[ 4, 208, 204, 208, 204, 204, 204, 204, 204, 204, 204, 205, 202, 204, 204, 201 ],
	[ 51, 4, 207, 204, 208, 205, 205, 205, 205, 205, 202, 204, 204, 204, 204, 202 ],
	[ 6, 51, 208, 204, 204, 204, 204, 204, 204, 204, 204, 204, 204, 204, 202, 12 ],
	[ 4, 4, 4, 208, 204, 204, 204, 204, 204, 204, 204, 204, 205, 202, 12, 11 ],
	[ 4, 4, 51, 4, 208, 205, 205, 205, 205, 205, 205, 202, 6, 4, 11, 11 ]
],
"objects": [
	{
		"class": "io.github.pokemeetup.system.gameplay.overworld.World$WorldObjectData",
		"x": -63616,
		"y": -24032,
		"type": "SNOW_TREE"
	},
	{
		"class": "io.github.pokemeetup.system.gameplay.overworld.World$WorldObjectData",
		"x": -64000,
		"y": -23936,
		"type": "SNOW_TREE"
	}
],
"blocks": [],
"lastModified": 0,
"isMultiplayer": false
}