{
"x": -125,
"y": -32,
"biomeType": "SNOW",
"tileData": [
	[ 4, 4, 4, 6, 4, 4, 4, 4, 4, 4, 4, 4, 4, 4, 201, 4 ],
	[ 51, 51, 206, 203, 203, 203, 203, 203, 203, 203, 203, 203, 203, 203, 201, 51 ],
	[ 4, 206, 204, 204, 204, 204, 204, 204, 204, 204, 204, 204, 204, 204, 201, 6 ],
	[ 206, 204, 204, 204, 206, 203, 203, 203, 203, 203, 203, 203, 200, 204, 201, 52 ],
	[ 207, 204, 204, 206, 204, 204, 204, 204, 204, 204, 204, 204, 204, 200, 204, 200 ],
	[ 207, 204, 204, 207, 204, 204, 206, 203, 200, 204, 204, 204, 204, 201, 204, 201 ],
	[ 207, 204, 204, 207, 204, 206, 204, 204, 204, 200, 204, 204, 204, 201, 204, 201 ],
	[ 207, 204, 206, 204, 204, 207, 204, 204, 204, 201, 204, 204, 204, 201, 204, 201 ],
	[ 207, 204, 207, 204, 204, 207, 204, 204, 204, 201, 204, 204, 204, 201, 204, 201 ],
	[ 207, 204, 207, 204, 204, 208, 204, 204, 204, 202, 204, 204, 204, 202, 204, 201 ],
	[ 207, 204, 207, 204, 204, 204, 208, 205, 202, 204, 204, 204, 201, 204, 204, 201 ],
	[ 207, 204, 207, 204, 204, 204, 204, 204, 204, 204, 204, 204, 201, 204, 204, 201 ],
	[ 207, 204, 208, 204, 204, 204, 204, 204, 204, 204, 204, 204, 202, 204, 204, 201 ],
	[ 207, 204, 204, 208, 205, 205, 204, 204, 204, 204, 205, 202, 204, 204, 204, 202 ],
	[ 208, 204, 204, 204, 204, 204, 208, 205, 205, 202, 204, 204, 204, 204, 202, 4 ],
	[ 7, 208, 205, 205, 205, 205, 205, 205, 205, 205, 205, 205, 205, 202, 4, 6 ]
],
"objects": [
	{
		"class": "io.github.pokemeetup.system.gameplay.overworld.World$WorldObjectData",
		"x": -64000,
		"y": -16032,
		"type": "SNOW_TREE"
	},
	{
		"class": "io.github.pokemeetup.system.gameplay.overworld.World$WorldObjectData",
		"x": -64000,
		"y": -16256,
		"type": "SNOW_TREE"
	}
],
"blocks": [],
"lastModified": 0,
"isMultiplayer": false
}