{
"x": -121,
"y": -11,
"biomeType": "SNOW",
"tileData": [
	[ 4, 4, 4, 6, 4, 4, 206, 203, 203, 203, 203, 200, 6, 6, 4, 4 ],
	[ 51, 6, 4, 4, 4, 206, 204, 204, 204, 204, 204, 204, 203, 200, 52, 4 ],
	[ 4, 4, 4, 4, 206, 204, 204, 206, 203, 203, 203, 200, 204, 204, 200, 4 ],
	[ 4, 4, 4, 206, 204, 204, 206, 204, 204, 204, 204, 204, 200, 204, 204, 200 ],
	[ 4, 206, 203, 204, 204, 206, 204, 206, 203, 203, 200, 204, 204, 200, 204, 201 ],
	[ 206, 204, 204, 204, 206, 204, 206, 204, 204, 204, 204, 200, 204, 201, 204, 201 ],
	[ 207, 204, 204, 206, 204, 206, 204, 204, 204, 204, 204, 201, 204, 201, 204, 201 ],
	[ 207, 204, 206, 204, 206, 204, 204, 204, 204, 204, 204, 202, 204, 204, 200, 201 ],
	[ 207, 206, 204, 204, 207, 204, 204, 204, 204, 204, 202, 204, 204, 204, 202, 201 ],
	[ 207, 207, 204, 206, 204, 204, 204, 204, 204, 202, 204, 204, 204, 202, 204, 201 ],
	[ 207, 207, 204, 208, 204, 204, 204, 204, 202, 204, 204, 204, 202, 204, 204, 201 ],
	[ 207, 208, 204, 204, 208, 205, 205, 202, 204, 204, 205, 202, 204, 204, 205, 202 ],
	[ 207, 204, 208, 204, 204, 204, 204, 204, 204, 202, 204, 204, 205, 202, 6, 4 ],
	[ 208, 204, 204, 208, 204, 204, 204, 204, 202, 204, 204, 202, 4, 6, 4, 51 ],
	[ 51, 207, 204, 204, 208, 205, 205, 202, 204, 204, 201, 4, 4, 4, 4, 6 ],
	[ 4, 208, 205, 205, 205, 205, 205, 205, 205, 205, 202, 6, 4, 4, 4, 4 ]
],
"objects": [
	{
		"class": "io.github.pokemeetup.system.gameplay.overworld.World$WorldObjectData",
		"x": -61888,
		"y": -5600,
		"type": "SNOW_TREE"
	},
	{
		"class": "io.github.pokemeetup.system.gameplay.overworld.World$WorldObjectData",
		"x": -61536,
		"y": -5152,
		"type": "SNOW_TREE"
	},
	{
		"class": "io.github.pokemeetup.system.gameplay.overworld.World$WorldObjectData",
		"x": -61952,
		"y": -5504,
		"type": "SNOW_TREE"
	},
	{
		"class": "io.github.pokemeetup.system.gameplay.overworld.World$WorldObjectData",
		"x": -61504,
		"y": -5248,
		"type": "SNOW_TREE"
	}
],
"blocks": [],
"lastModified": 0,
"isMultiplayer": false
}