{
"x": -111,
"y": -15,
"biomeType": "SNOW",
"tileData": [
	[ 4, 4, 4, 4, 206, 203, 203, 206, 203, 203, 203, 203, 203, 200, 203, 200 ],
	[ 4, 4, 4, 206, 204, 204, 206, 204, 204, 204, 204, 204, 204, 204, 203, 200 ],
	[ 4, 4, 4, 207, 204, 206, 204, 204, 204, 206, 203, 203, 200, 204, 204, 201 ],
	[ 4, 4, 4, 207, 204, 207, 204, 204, 206, 204, 204, 204, 204, 200, 204, 201 ],
	[ 4, 4, 4, 207, 204, 207, 204, 204, 207, 204, 204, 204, 204, 204, 200, 201 ],
	[ 4, 4, 52, 207, 204, 207, 204, 204, 207, 204, 204, 204, 204, 204, 202, 201 ],
	[ 4, 4, 206, 204, 204, 207, 204, 204, 208, 204, 204, 204, 205, 202, 204, 202 ],
	[ 11, 4, 207, 204, 206, 204, 204, 202, 204, 207, 204, 202, 204, 204, 202, 201 ],
	[ 1, 206, 204, 204, 207, 204, 235, 204, 206, 204, 201, 204, 204, 202, 204, 202 ],
	[ 206, 204, 204, 206, 204, 204, 206, 203, 204, 204, 201, 204, 201, 204, 202, 10 ],
	[ 207, 204, 206, 204, 204, 206, 204, 204, 204, 204, 201, 205, 202, 235, 1, 10 ],
	[ 207, 206, 204, 204, 206, 204, 204, 204, 204, 204, 202, 204, 204, 201, 1, 10 ],
	[ 207, 208, 204, 204, 208, 204, 204, 204, 204, 202, 204, 204, 204, 202, 24, 1 ],
	[ 208, 204, 208, 204, 204, 208, 205, 205, 202, 235, 204, 204, 201, 24, 1, 10 ],
	[ 11, 207, 204, 208, 204, 204, 204, 204, 204, 202, 204, 204, 202, 24, 1, 1 ],
	[ 1, 208, 205, 205, 208, 205, 205, 205, 202, 205, 205, 202, 22, 1, 1, 1 ]
],
"objects": [
	{
		"class": "io.github.pokemeetup.system.gameplay.overworld.World$WorldObjectData",
		"x": -56768,
		"y": -7648,
		"type": "SNOW_TREE"
	},
	{
		"class": "io.github.pokemeetup.system.gameplay.overworld.World$WorldObjectData",
		"x": -56672,
		"y": -7680,
		"type": "SNOW_TREE"
	},
	{
		"class": "io.github.pokemeetup.system.gameplay.overworld.World$WorldObjectData",
		"x": -56352,
		"y": -7264,
		"type": "POKEBALL"
	}
],
"blocks": [],
"lastModified": 0,
"isMultiplayer": false
}