{
"x": -122,
"y": -25,
"biomeType": "HAUNTED",
"tileData": [
	[ 4, 5, 7, 5, 7, 5, 7, 5, 8, 5, 7, 4, 4, 51, 4, 4 ],
	[ 51, 9, 7, 7, 5, 5, 7, 7, 5, 5, 5, 5, 4, 51, 4, 51 ],
	[ 9, 5, 7, 5, 7, 8, 9, 5, 5, 7, 5, 5, 7, 4, 4, 51 ],
	[ 5, 7, 5, 7, 7, 5, 7, 5, 5, 5, 7, 7, 5, 52, 4, 4 ],
	[ 5, 5, 7, 1, 7, 8, 8, 9, 7, 5, 5, 5, 5, 5, 4, 4 ],
	[ 5, 7, 7, 9, 5, 5, 5, 5, 5, 5, 8, 7, 7, 7, 5, 4 ],
	[ 5, 9, 5, 5, 10, 7, 7, 5, 8, 7, 1, 9, 5, 8, 5, 51 ],
	[ 5, 5, 9, 5, 5, 5, 5, 7, 9, 5, 7, 5, 5, 5, 7, 5 ],
	[ 7, 5, 1, 7, 5, 5, 5, 7, 5, 7, 5, 5, 5, 8, 9, 5 ],
	[ 5, 8, 7, 5, 5, 5, 9, 5, 8, 7, 5, 5, 7, 7, 7, 1 ],
	[ 5, 7, 5, 5, 5, 5, 9, 7, 5, 5, 5, 7, 7, 5, 8, 7 ],
	[ 5, 5, 5, 5, 7, 1, 7, 5, 5, 7, 5, 7, 8, 8, 7, 5 ],
	[ 8, 8, 7, 5, 5, 9, 7, 5, 9, 7, 5, 9, 7, 7, 5, 7 ],
	[ 5, 7, 5, 5, 5, 5, 5, 5, 5, 5, 5, 7, 7, 5, 7, 7 ],
	[ 10, 5, 7, 7, 5, 5, 5, 5, 5, 7, 5, 5, 5, 7, 7, 7 ],
	[ 7, 7, 7, 5, 5, 5, 7, 5, 5, 9, 5, 5, 7, 8, 7, 5 ]
],
"objects": [
	{
		"class": "io.github.pokemeetup.system.gameplay.overworld.World$WorldObjectData",
		"x": -62464,
		"y": -12448,
		"type": "SNOW_TREE"
	},
	{
		"class": "io.github.pokemeetup.system.gameplay.overworld.World$WorldObjectData",
		"x": -62272,
		"y": -12320,
		"type": "SNOW_TREE"
	},
	{
		"class": "io.github.pokemeetup.system.gameplay.overworld.World$WorldObjectData",
		"x": -62176,
		"y": -12320,
		"type": "POKEBALL"
	}
],
"blocks": [],
"lastModified": 0,
"isMultiplayer": false
}