{
"x": -127,
"y": -24,
"biomeType": "PLAINS",
"tileData": [
	[ 4, 10, 1, 1, 1, 10, 1, 1, 24, 207, 203, 203, 203, 200, 1, 24 ],
	[ 4, 24, 24, 1, 10, 10, 1, 1, 1, 10, 1, 208, 205, 205, 200, 1 ],
	[ 1, 1, 1, 10, 1, 1, 1, 22, 1, 1, 24, 1, 10, 10, 201, 10 ],
	[ 1, 10, 10, 1, 10, 1, 22, 24, 10, 10, 10, 10, 1, 10, 1, 10 ],
	[ 10, 10, 1, 1, 1, 1, 1, 10, 1, 10, 1, 10, 1, 1, 1, 10 ],
	[ 1, 10, 10, 1, 10, 10, 24, 24, 1, 1, 10, 10, 1, 10, 10, 1 ],
	[ 1, 10, 1, 23, 24, 1, 10, 10, 10, 10, 1, 1, 1, 1, 1, 1 ],
	[ 1, 10, 1, 10, 10, 1, 206, 203, 203, 203, 200, 1, 10, 10, 1, 24 ],
	[ 1, 1, 1, 1, 1, 206, 204, 204, 204, 204, 204, 203, 200, 1, 10, 1 ],
	[ 10, 10, 24, 10, 1, 207, 204, 204, 204, 204, 204, 204, 201, 24, 10, 1 ],
	[ 1, 10, 1, 1, 1, 207, 204, 204, 204, 204, 204, 204, 201, 1, 10, 10 ],
	[ 10, 1, 1, 10, 10, 207, 204, 204, 204, 204, 204, 204, 201, 24, 1, 10 ],
	[ 1, 1, 1, 10, 24, 207, 204, 204, 204, 204, 204, 204, 202, 1, 1, 1 ],
	[ 1, 1, 1, 1, 10, 208, 204, 204, 204, 204, 204, 202, 1, 1, 1, 1 ],
	[ 1, 24, 24, 1, 24, 1, 207, 204, 204, 204, 202, 24, 24, 1, 10, 10 ],
	[ 10, 1, 1, 10, 1, 1, 208, 205, 205, 202, 1, 1, 1, 10, 24, 1 ]
],
"objects": [
	{
		"class": "io.github.pokemeetup.system.gameplay.overworld.World$WorldObjectData",
		"x": -64896,
		"y": -11872,
		"type": "POKEBALL"
	}
],
"blocks": [],
"lastModified": 0,
"isMultiplayer": false
}