{
"x": -127,
"y": -32,
"biomeType": "SNOW",
"tileData": [
	[ 4, 4, 4, 6, 51, 206, 203, 203, 206, 203, 200, 203, 203, 200, 4, 4 ],
	[ 4, 4, 52, 4, 206, 204, 204, 206, 204, 204, 204, 203, 200, 204, 200, 4 ],
	[ 6, 52, 51, 206, 204, 204, 206, 204, 204, 204, 204, 204, 204, 200, 204, 200 ],
	[ 4, 4, 4, 207, 204, 206, 204, 204, 204, 206, 200, 204, 204, 201, 204, 201 ],
	[ 4, 51, 4, 207, 204, 207, 204, 204, 206, 204, 204, 200, 204, 201, 204, 201 ],
	[ 4, 4, 4, 207, 204, 207, 204, 204, 207, 204, 204, 204, 200, 235, 204, 201 ],
	[ 4, 51, 206, 204, 204, 207, 204, 204, 208, 204, 204, 204, 202, 204, 200, 201 ],
	[ 6, 4, 207, 204, 204, 207, 204, 204, 204, 208, 205, 202, 204, 204, 201, 201 ],
	[ 4, 4, 207, 204, 206, 204, 204, 204, 204, 204, 204, 204, 204, 204, 202, 201 ],
	[ 4, 4, 207, 204, 207, 204, 204, 204, 204, 204, 204, 204, 204, 201, 204, 201 ],
	[ 4, 206, 204, 204, 207, 204, 204, 204, 204, 204, 204, 204, 204, 202, 204, 201 ],
	[ 51, 207, 204, 206, 204, 204, 204, 204, 204, 204, 204, 204, 202, 204, 204, 201 ],
	[ 4, 207, 204, 208, 204, 204, 204, 204, 204, 204, 205, 202, 204, 204, 204, 201 ],
	[ 4, 207, 204, 204, 207, 204, 204, 204, 204, 202, 204, 204, 204, 204, 204, 201 ],
	[ 4, 207, 204, 204, 208, 204, 204, 205, 202, 204, 204, 204, 204, 204, 204, 201 ],
	[ 4, 208, 205, 205, 205, 208, 202, 205, 205, 205, 205, 205, 205, 205, 205, 202 ]
],
"objects": [
	{
		"class": "io.github.pokemeetup.system.gameplay.overworld.World$WorldObjectData",
		"x": -64864,
		"y": -16384,
		"type": "SNOW_TREE"
	},
	{
		"class": "io.github.pokemeetup.system.gameplay.overworld.World$WorldObjectData",
		"x": -65024,
		"y": -16256,
		"type": "SNOW_TREE"
	},
	{
		"class": "io.github.pokemeetup.system.gameplay.overworld.World$WorldObjectData",
		"x": -64608,
		"y": -16384,
		"type": "SNOW_TREE"
	},
	{
		"class": "io.github.pokemeetup.system.gameplay.overworld.World$WorldObjectData",
		"x": -64768,
		"y": -16352,
		"type": "SNOW_TREE"
	}
],
"blocks": [],
"lastModified": 0,
"isMultiplayer": false
}