{
"x": -121,
"y": -14,
"biomeType": "SNOW",
"tileData": [
	[ 4, 206, 203, 206, 203, 203, 203, 203, 203, 203, 203, 203, 203, 200, 203, 200 ],
	[ 206, 204, 206, 204, 204, 204, 204, 204, 204, 204, 204, 204, 204, 201, 204, 201 ],
	[ 207, 206, 204, 204, 204, 204, 204, 204, 204, 206, 203, 200, 204, 204, 200, 201 ],
	[ 207, 207, 204, 204, 206, 203, 203, 203, 203, 204, 204, 204, 200, 204, 204, 200 ],
	[ 207, 207, 204, 206, 204, 204, 204, 204, 204, 204, 204, 204, 201, 204, 204, 201 ],
	[ 207, 208, 235, 207, 204, 204, 204, 204, 204, 204, 204, 204, 202, 204, 204, 201 ],
	[ 207, 204, 204, 207, 204, 204, 204, 204, 204, 204, 205, 202, 204, 204, 204, 202 ],
	[ 207, 204, 204, 207, 204, 204, 204, 204, 204, 201, 204, 235, 204, 204, 202, 201 ],
	[ 207, 204, 204, 207, 204, 204, 204, 204, 204, 202, 203, 204, 205, 202, 204, 201 ],
	[ 208, 204, 204, 208, 204, 204, 204, 205, 202, 204, 204, 202, 204, 204, 204, 202 ],
	[ 4, 207, 204, 207, 208, 205, 202, 204, 204, 204, 202, 204, 204, 205, 202, 4 ],
	[ 4, 235, 207, 204, 204, 204, 204, 204, 205, 202, 204, 205, 202, 4, 4, 4 ],
	[ 51, 208, 204, 208, 204, 204, 205, 202, 204, 235, 202, 4, 51, 4, 6, 4 ],
	[ 4, 4, 208, 204, 208, 202, 204, 205, 202, 4, 4, 4, 6, 4, 4, 4 ],
	[ 4, 52, 4, 208, 205, 204, 202, 4, 4, 6, 4, 4, 4, 51, 4, 4 ],
	[ 4, 4, 4, 4, 6, 201, 4, 4, 4, 4, 6, 52, 4, 4, 4, 6 ]
],
"objects": [
	{
		"class": "io.github.pokemeetup.system.gameplay.overworld.World$WorldObjectData",
		"x": -61536,
		"y": -6816,
		"type": "SNOW_TREE"
	},
	{
		"class": "io.github.pokemeetup.system.gameplay.overworld.World$WorldObjectData",
		"x": -61504,
		"y": -6912,
		"type": "SNOW_TREE"
	},
	{
		"class": "io.github.pokemeetup.system.gameplay.overworld.World$WorldObjectData",
		"x": -61536,
		"y": -6688,
		"type": "SNOW_TREE"
	}
],
"blocks": [],
"lastModified": 0,
"isMultiplayer": false
}