{
"x": -123,
"y": -15,
"biomeType": "SNOW",
"tileData": [
	[ 10, 1, 10, 1, 4, 4, 4, 4, 4, 4, 4, 52, 52, 51, 4, 4 ],
	[ 1, 1, 4, 51, 4, 4, 4, 4, 51, 4, 6, 6, 4, 6, 4, 4 ],
	[ 10, 4, 4, 4, 206, 203, 203, 203, 203, 203, 203, 203, 203, 203, 200, 4 ],
	[ 51, 4, 4, 51, 207, 204, 204, 204, 204, 204, 204, 204, 204, 204, 204, 200 ],
	[ 4, 6, 51, 4, 207, 204, 204, 206, 200, 204, 204, 204, 204, 204, 204, 201 ],
	[ 6, 4, 4, 4, 207, 204, 206, 204, 204, 235, 206, 200, 204, 206, 203, 200 ],
	[ 4, 4, 4, 4, 207, 204, 207, 204, 204, 206, 204, 204, 200, 204, 204, 201 ],
	[ 4, 4, 4, 4, 235, 206, 204, 204, 206, 204, 204, 204, 201, 204, 204, 201 ],
	[ 4, 6, 52, 4, 207, 207, 204, 204, 207, 204, 204, 204, 201, 204, 204, 202 ],
	[ 4, 51, 4, 206, 204, 207, 204, 204, 208, 204, 204, 204, 202, 204, 201, 201 ],
	[ 4, 4, 51, 207, 204, 207, 204, 204, 204, 208, 205, 202, 204, 204, 202, 201 ],
	[ 4, 51, 4, 207, 204, 208, 204, 204, 204, 204, 204, 204, 204, 201, 204, 201 ],
	[ 52, 4, 207, 204, 204, 204, 208, 204, 204, 204, 204, 204, 204, 202, 204, 201 ],
	[ 4, 4, 4, 207, 204, 204, 204, 208, 205, 204, 204, 204, 202, 204, 204, 201 ],
	[ 4, 4, 51, 208, 204, 204, 204, 204, 204, 208, 205, 202, 204, 204, 204, 201 ],
	[ 52, 6, 4, 4, 208, 205, 205, 205, 205, 205, 205, 205, 205, 205, 205, 202 ]
],
"objects": [
	{
		"class": "io.github.pokemeetup.system.gameplay.overworld.World$WorldObjectData",
		"x": -62976,
		"y": -7648,
		"type": "TREE_1"
	},
	{
		"class": "io.github.pokemeetup.system.gameplay.overworld.World$WorldObjectData",
		"x": -62976,
		"y": -7584,
		"type": "POKEBALL"
	}
],
"blocks": [],
"lastModified": 0,
"isMultiplayer": false
}