{
"x": -122,
"y": -52,
"biomeType": "SNOW",
"tileData": [
	[ 4, 51, 4, 206, 203, 203, 203, 201, 203, 203, 200, 4, 4, 4, 4, 4 ],
	[ 51, 4, 206, 204, 206, 203, 203, 204, 203, 200, 204, 200, 4, 51, 4, 51 ],
	[ 4, 206, 204, 206, 204, 204, 204, 204, 204, 204, 200, 204, 200, 4, 51, 4 ],
	[ 206, 204, 204, 207, 204, 206, 203, 200, 204, 204, 201, 204, 204, 200, 4, 4 ],
	[ 207, 204, 206, 204, 206, 204, 204, 204, 200, 204, 201, 204, 204, 201, 51, 5 ],
	[ 207, 204, 207, 204, 207, 204, 204, 204, 202, 204, 201, 204, 204, 201, 5, 7 ],
	[ 207, 204, 207, 204, 208, 204, 204, 202, 204, 204, 204, 200, 204, 204, 200, 5 ],
	[ 207, 204, 208, 204, 204, 208, 202, 204, 204, 204, 204, 204, 200, 204, 201, 7 ],
	[ 207, 204, 204, 208, 204, 204, 204, 204, 204, 204, 204, 204, 201, 204, 204, 200 ],
	[ 207, 204, 204, 204, 208, 204, 204, 204, 204, 204, 204, 204, 201, 204, 204, 201 ],
	[ 208, 205, 204, 204, 204, 208, 204, 204, 204, 204, 204, 204, 202, 204, 204, 201 ],
	[ 4, 51, 208, 205, 204, 204, 208, 204, 204, 204, 205, 202, 204, 204, 204, 201 ],
	[ 4, 5, 7, 7, 207, 204, 204, 208, 205, 202, 204, 204, 204, 204, 204, 201 ],
	[ 5, 5, 5, 5, 208, 204, 204, 204, 204, 204, 204, 204, 205, 205, 204, 201 ],
	[ 9, 7, 5, 7, 7, 208, 204, 204, 204, 204, 205, 202, 5, 5, 208, 202 ],
	[ 9, 7, 7, 7, 5, 5, 208, 205, 205, 202, 9, 5, 5, 8, 7, 5 ]
],
"objects": [
	{
		"class": "io.github.pokemeetup.system.gameplay.overworld.World$WorldObjectData",
		"x": -62464,
		"y": -26272,
		"type": "SNOW_TREE"
	}
],
"blocks": [],
"lastModified": 0,
"isMultiplayer": false
}