{
"x": -124,
"y": -31,
"biomeType": "HAUNTED",
"tileData": [
	[ 4, 4, 4, 51, 4, 4, 4, 4, 4, 4, 6, 51, 4, 4, 4, 4 ],
	[ 5, 7, 7, 7, 5, 5, 7, 5, 7, 7, 5, 5, 7, 5, 7, 9 ],
	[ 5, 5, 5, 5, 9, 5, 5, 5, 5, 8, 7, 7, 7, 5, 5, 9 ],
	[ 7, 7, 5, 9, 5, 5, 9, 5, 8, 9, 7, 5, 5, 7, 5, 7 ],
	[ 1, 7, 5, 5, 5, 7, 7, 7, 5, 9, 5, 5, 7, 9, 5, 5 ],
	[ 5, 5, 5, 5, 5, 7, 5, 5, 7, 5, 5, 5, 7, 1, 9, 5 ],
	[ 9, 5, 7, 7, 1, 7, 7, 5, 5, 5, 9, 7, 5, 8, 5, 5 ],
	[ 5, 5, 7, 5, 5, 7, 8, 5, 5, 5, 5, 7, 5, 7, 5, 5 ],
	[ 5, 9, 7, 7, 7, 9, 8, 8, 9, 1, 5, 7, 5, 5, 5, 7 ],
	[ 5, 5, 8, 5, 7, 5, 5, 5, 7, 7, 5, 8, 5, 5, 7, 7 ],
	[ 9, 7, 5, 8, 5, 5, 7, 5, 5, 5, 7, 5, 5, 9, 5, 9 ],
	[ 5, 5, 5, 5, 5, 7, 10, 5, 7, 7, 5, 5, 9, 8, 5, 5 ],
	[ 5, 5, 5, 5, 1, 5, 10, 5, 5, 5, 5, 7, 7, 9, 7, 7 ],
	[ 8, 7, 5, 5, 5, 5, 5, 7, 5, 5, 7, 7, 5, 7, 7, 5 ],
	[ 5, 5, 9, 5, 8, 5, 7, 5, 5, 7, 8, 8, 5, 5, 5, 7 ],
	[ 7, 1, 7, 5, 5, 7, 5, 5, 5, 7, 5, 5, 5, 5, 5, 7 ]
],
"objects": [
	{
		"class": "io.github.pokemeetup.system.gameplay.overworld.World$WorldObjectData",
		"x": -63488,
		"y": -15520,
		"type": "SNOW_TREE"
	},
	{
		"class": "io.github.pokemeetup.system.gameplay.overworld.World$WorldObjectData",
		"x": -63488,
		"y": -15744,
		"type": "SNOW_TREE"
	},
	{
		"class": "io.github.pokemeetup.system.gameplay.overworld.World$WorldObjectData",
		"x": -63360,
		"y": -15872,
		"type": "POKEBALL"
	}
],
"blocks": [],
"lastModified": 0,
"isMultiplayer": false
}