{
"x": -120,
"y": -9,
"biomeType": "PLAINS",
"tileData": [
	[ 4, 4, 1, 1, 10, 1, 10, 1, 1, 1, 1, 1, 1, 1, 10, 1 ],
	[ 51, 1, 1, 1, 24, 1, 24, 1, 1, 1, 10, 24, 1, 1, 1, 10 ],
	[ 10, 10, 1, 10, 1, 23, 24, 10, 1, 10, 10, 1, 1, 1, 1, 1 ],
	[ 10, 1, 10, 1, 10, 10, 10, 1, 24, 1, 1, 10, 10, 1, 1, 10 ],
	[ 1, 10, 24, 10, 10, 1, 1, 10, 10, 10, 24, 10, 1, 1, 1, 1 ],
	[ 1, 22, 10, 1, 1, 1, 1, 22, 10, 1, 1, 1, 10, 10, 10, 1 ],
	[ 1, 1, 10, 1, 1, 1, 10, 10, 10, 1, 1, 1, 10, 1, 1, 1 ],
	[ 24, 1, 1, 10, 24, 1, 1, 10, 24, 1, 1, 10, 1, 1, 10, 1 ],
	[ 1, 1, 1, 10, 24, 22, 1, 10, 1, 1, 10, 10, 10, 24, 10, 1 ],
	[ 10, 1, 1, 1, 24, 10, 10, 1, 1, 1, 1, 10, 1, 10, 10, 1 ],
	[ 10, 24, 10, 10, 10, 10, 1, 1, 1, 24, 10, 1, 1, 1, 10, 10 ],
	[ 1, 1, 10, 22, 24, 1, 1, 10, 1, 1, 1, 10, 1, 10, 1, 1 ],
	[ 1, 10, 1, 1, 1, 10, 1, 24, 1, 24, 1, 10, 1, 24, 1, 10 ],
	[ 1, 24, 1, 10, 1, 24, 1, 1, 10, 1, 1, 1, 10, 10, 1, 24 ],
	[ 1, 10, 10, 10, 1, 1, 1, 1, 24, 1, 1, 1, 1, 1, 10, 1 ],
	[ 10, 1, 10, 10, 1, 10, 22, 10, 1, 1, 1, 24, 1, 1, 10, 1 ]
],
"objects": [
	{
		"class": "io.github.pokemeetup.system.gameplay.overworld.World$WorldObjectData",
		"x": -61088,
		"y": -4448,
		"type": "POKEBALL"
	}
],
"blocks": [],
"lastModified": 0,
"isMultiplayer": false
}