{
"x": -123,
"y": -27,
"biomeType": "SNOW",
"tileData": [
	[ 206, 203, 203, 203, 203, 203, 203, 203, 203, 200, 4, 4, 4, 4, 4, 4 ],
	[ 207, 206, 203, 203, 203, 203, 203, 200, 204, 204, 203, 200, 4, 4, 4, 4 ],
	[ 206, 204, 204, 204, 204, 204, 204, 204, 203, 200, 204, 204, 203, 200, 4, 4 ],
	[ 207, 204, 204, 204, 204, 204, 204, 204, 204, 204, 200, 204, 204, 201, 4, 4 ],
	[ 207, 204, 204, 204, 204, 204, 204, 204, 204, 204, 204, 200, 204, 204, 200, 4 ],
	[ 207, 204, 204, 204, 204, 204, 204, 204, 204, 204, 204, 201, 204, 204, 201, 52 ],
	[ 208, 204, 204, 204, 204, 204, 204, 204, 204, 204, 204, 201, 204, 204, 202, 4 ],
	[ 207, 208, 204, 204, 204, 204, 204, 204, 204, 204, 204, 202, 204, 201, 4, 52 ],
	[ 207, 204, 208, 204, 204, 204, 204, 204, 204, 204, 202, 204, 204, 201, 4, 6 ],
	[ 208, 204, 204, 208, 204, 204, 204, 204, 205, 202, 204, 204, 204, 201, 4, 4 ],
	[ 7, 208, 204, 204, 208, 205, 205, 202, 204, 204, 204, 204, 205, 204, 203, 200 ],
	[ 5, 5, 208, 204, 204, 204, 204, 204, 204, 204, 205, 202, 5, 208, 204, 201 ],
	[ 9, 7, 235, 204, 204, 204, 204, 204, 205, 202, 235, 8, 7, 5, 207, 201 ],
	[ 5, 8, 5, 8, 207, 205, 205, 202, 7, 8, 5, 7, 8, 5, 208, 201 ],
	[ 7, 5, 5, 7, 201, 5, 235, 7, 7, 5, 1, 5, 7, 7, 7, 201 ],
	[ 7, 7, 9, 9, 7, 5, 8, 8, 7, 5, 5, 7, 8, 9, 5, 5 ]
],
"objects": [
	{
		"class": "io.github.pokemeetup.system.gameplay.overworld.World$WorldObjectData",
		"x": -62976,
		"y": -13472,
		"type": "SNOW_TREE"
	},
	{
		"class": "io.github.pokemeetup.system.gameplay.overworld.World$WorldObjectData",
		"x": -62784,
		"y": -13344,
		"type": "SNOW_TREE"
	},
	{
		"class": "io.github.pokemeetup.system.gameplay.overworld.World$WorldObjectData",
		"x": -62528,
		"y": -13504,
		"type": "POKEBALL"
	}
],
"blocks": [],
"lastModified": 0,
"isMultiplayer": false
}