{
"x": -125,
"y": -48,
"biomeType": "SNOW",
"tileData": [
	[ 5, 4, 4, 4, 4, 6, 6, 4, 51, 4, 4, 4, 51, 4, 4, 4 ],
	[ 51, 4, 4, 4, 6, 4, 4, 4, 4, 4, 4, 6, 4, 51, 51, 4 ],
	[ 4, 4, 4, 4, 4, 4, 6, 4, 4, 4, 4, 4, 4, 4, 4, 4 ],
	[ 4, 4, 4, 4, 6, 4, 4, 4, 4, 6, 4, 6, 4, 51, 4, 6 ],
	[ 4, 206, 203, 203, 203, 203, 203, 200, 4, 4, 51, 4, 4, 4, 4, 4 ],
	[ 206, 204, 204, 204, 204, 204, 204, 204, 203, 200, 4, 4, 6, 4, 6, 6 ],
	[ 207, 204, 204, 204, 206, 203, 203, 200, 204, 204, 203, 200, 51, 51, 51, 4 ],
	[ 207, 204, 204, 206, 204, 204, 204, 204, 203, 200, 204, 204, 200, 4, 52, 4 ],
	[ 207, 204, 206, 204, 204, 204, 201, 204, 204, 204, 200, 204, 204, 200, 51, 6 ],
	[ 207, 206, 204, 204, 204, 207, 204, 201, 204, 204, 204, 200, 204, 201, 4, 4 ],
	[ 207, 208, 204, 204, 204, 204, 201, 204, 204, 204, 204, 201, 204, 201, 4, 4 ],
	[ 207, 204, 208, 205, 204, 204, 204, 204, 204, 204, 204, 202, 204, 202, 4, 4 ],
	[ 207, 204, 204, 204, 208, 205, 204, 204, 204, 204, 202, 204, 202, 4, 4, 4 ],
	[ 208, 205, 204, 204, 204, 204, 208, 205, 205, 202, 204, 201, 4, 4, 4, 4 ],
	[ 51, 51, 208, 205, 205, 204, 204, 204, 204, 204, 204, 202, 6, 6, 4, 6 ],
	[ 4, 51, 4, 4, 4, 208, 205, 205, 205, 205, 202, 4, 4, 4, 4, 4 ]
],
"objects": [
	{
		"class": "io.github.pokemeetup.system.gameplay.overworld.World$WorldObjectData",
		"x": -64000,
		"y": -24576,
		"type": "HAUNTED_TREE"
	}
],
"blocks": [],
"lastModified": 0,
"isMultiplayer": false
}