{
"x": -122,
"y": -49,
"biomeType": "SNOW",
"tileData": [
	[ 4, 51, 4, 4, 206, 203, 203, 206, 200, 203, 203, 203, 200, 4, 4, 6 ],
	[ 4, 6, 4, 6, 207, 204, 206, 204, 204, 203, 200, 204, 204, 200, 4, 4 ],
	[ 4, 4, 4, 206, 204, 206, 204, 204, 204, 204, 204, 200, 204, 204, 200, 4 ],
	[ 4, 4, 4, 207, 206, 204, 204, 206, 200, 204, 204, 204, 200, 204, 204, 200 ],
	[ 6, 4, 206, 204, 207, 204, 206, 204, 204, 200, 204, 204, 204, 200, 204, 201 ],
	[ 206, 235, 204, 206, 204, 206, 204, 204, 204, 204, 200, 204, 204, 201, 204, 201 ],
	[ 207, 206, 203, 204, 204, 207, 204, 204, 204, 204, 202, 204, 204, 204, 200, 201 ],
	[ 206, 204, 204, 204, 206, 204, 204, 204, 205, 202, 204, 204, 204, 204, 204, 201 ],
	[ 207, 204, 204, 206, 204, 204, 204, 201, 204, 235, 204, 204, 204, 204, 201, 201 ],
	[ 207, 204, 206, 204, 204, 204, 204, 201, 203, 204, 204, 204, 204, 204, 202, 201 ],
	[ 207, 204, 207, 204, 204, 204, 204, 201, 204, 204, 204, 204, 204, 202, 204, 202 ],
	[ 207, 204, 208, 204, 204, 204, 204, 202, 204, 204, 204, 204, 202, 204, 202, 4 ],
	[ 208, 204, 204, 208, 205, 205, 202, 204, 204, 204, 205, 202, 204, 201, 4, 6 ],
	[ 207, 207, 204, 204, 204, 204, 204, 204, 204, 202, 204, 204, 204, 202, 4, 4 ],
	[ 207, 208, 204, 204, 204, 204, 204, 204, 202, 204, 204, 204, 201, 4, 4, 4 ],
	[ 208, 205, 208, 205, 205, 205, 205, 202, 205, 205, 205, 205, 202, 4, 4, 4 ]
],
"objects": [
	{
		"class": "io.github.pokemeetup.system.gameplay.overworld.World$WorldObjectData",
		"x": -62400,
		"y": -25056,
		"type": "SNOW_TREE"
	},
	{
		"class": "io.github.pokemeetup.system.gameplay.overworld.World$WorldObjectData",
		"x": -62048,
		"y": -24608,
		"type": "SNOW_TREE"
	}
],
"blocks": [],
"lastModified": 0,
"isMultiplayer": false
}