{
"x": -70,
"y": 1,
"biomeType": "HAUNTED",
"tileData": [
	[ 51, 12, 11, 12, 11, 1, 10, 11, 11, 11, 11, 11, 10, 12, 1, 10 ],
	[ 7, 5, 5, 5, 9, 11, 11, 1, 11, 11, 5, 7, 7, 5, 7, 9 ],
	[ 7, 5, 5, 7, 8, 5, 7, 7, 5, 5, 9, 7, 7, 7, 10, 5 ],
	[ 5, 5, 9, 9, 5, 5, 7, 5, 5, 5, 7, 5, 9, 7, 5, 5 ],
	[ 5, 5, 5, 5, 7, 7, 5, 5, 5, 8, 5, 7, 7, 5, 5, 5 ],
	[ 7, 1, 8, 7, 7, 5, 7, 1, 9, 5, 7, 5, 5, 5, 7, 7 ],
	[ 5, 5, 9, 5, 5, 5, 5, 7, 5, 8, 10, 5, 5, 9, 7, 5 ],
	[ 8, 5, 7, 5, 5, 1, 7, 5, 7, 5, 7, 5, 7, 9, 5, 5 ],
	[ 5, 5, 5, 5, 1, 5, 5, 7, 9, 7, 5, 5, 7, 9, 7, 7 ],
	[ 7, 7, 5, 10, 5, 7, 9, 5, 5, 5, 7, 5, 7, 7, 7, 5 ],
	[ 5, 5, 5, 1, 5, 5, 5, 5, 7, 7, 5, 9, 7, 5, 5, 5 ],
	[ 5, 5, 9, 7, 5, 7, 5, 5, 10, 5, 7, 10, 9, 5, 7, 1 ],
	[ 1, 5, 7, 5, 7, 5, 5, 1, 9, 5, 7, 5, 5, 5, 7, 7 ],
	[ 7, 5, 7, 7, 5, 9, 7, 5, 5, 5, 7, 5, 5, 7, 5, 9 ],
	[ 5, 5, 7, 5, 5, 1, 5, 8, 7, 7, 5, 5, 7, 7, 5, 9 ],
	[ 5, 5, 7, 5, 7, 5, 5, 5, 5, 5, 7, 5, 5, 9, 5, 1 ]
],
"objects": [
	{
		"class": "io.github.pokemeetup.system.gameplay.overworld.World$WorldObjectData",
		"x": -35680,
		"y": 544,
		"type": "POKEBALL"
	}
],
"blocks": [],
"lastModified": 0,
"isMultiplayer": false
}