{
"x": -126,
"y": -32,
"biomeType": "SNOW",
"tileData": [
	[ 4, 6, 4, 4, 206, 203, 203, 203, 203, 203, 203, 203, 203, 203, 203, 200 ],
	[ 4, 51, 206, 203, 204, 204, 204, 204, 204, 204, 204, 204, 204, 204, 204, 201 ],
	[ 6, 206, 204, 204, 206, 203, 203, 203, 200, 204, 204, 204, 204, 204, 204, 201 ],
	[ 206, 204, 204, 206, 204, 204, 204, 204, 204, 203, 200, 204, 204, 204, 204, 201 ],
	[ 207, 204, 204, 207, 204, 204, 204, 204, 204, 204, 204, 203, 203, 200, 204, 201 ],
	[ 207, 204, 206, 204, 204, 204, 206, 203, 200, 204, 204, 204, 204, 204, 200, 201 ],
	[ 207, 204, 207, 204, 204, 206, 204, 204, 204, 203, 200, 204, 204, 204, 201, 201 ],
	[ 207, 204, 207, 204, 204, 207, 204, 204, 204, 204, 204, 200, 204, 204, 204, 200 ],
	[ 207, 206, 204, 204, 206, 204, 204, 204, 204, 204, 204, 204, 200, 204, 204, 201 ],
	[ 207, 207, 204, 204, 207, 204, 204, 204, 204, 204, 204, 204, 202, 204, 204, 202 ],
	[ 207, 207, 204, 204, 208, 204, 204, 204, 204, 204, 205, 202, 204, 204, 202, 201 ],
	[ 207, 208, 204, 204, 204, 208, 205, 205, 205, 202, 204, 204, 205, 202, 204, 201 ],
	[ 207, 204, 208, 205, 204, 204, 204, 204, 204, 204, 205, 202, 204, 204, 204, 201 ],
	[ 208, 205, 204, 204, 208, 205, 205, 205, 205, 202, 204, 204, 204, 205, 205, 202 ],
	[ 52, 4, 208, 205, 235, 205, 205, 204, 204, 204, 205, 205, 202, 4, 6, 4 ],
	[ 51, 52, 6, 4, 4, 4, 4, 208, 205, 202, 51, 4, 4, 4, 4, 201 ]
],
"objects": [],
"blocks": [],
"lastModified": 0,
"isMultiplayer": false
}