{
"x": -123,
"y": -26,
"biomeType": "SNOW",
"tileData": [
	[ 51, 51, 4, 206, 203, 203, 203, 203, 206, 203, 203, 200, 203, 203, 200, 5 ],
	[ 4, 206, 203, 204, 204, 204, 206, 203, 204, 204, 204, 204, 203, 200, 204, 200 ],
	[ 206, 204, 204, 204, 204, 206, 204, 204, 204, 204, 204, 204, 204, 204, 200, 201 ],
	[ 207, 204, 204, 206, 203, 204, 204, 204, 204, 206, 200, 204, 204, 204, 204, 200 ],
	[ 207, 204, 206, 204, 204, 204, 204, 206, 203, 204, 204, 203, 200, 204, 204, 201 ],
	[ 207, 204, 207, 204, 204, 204, 206, 204, 204, 204, 204, 204, 204, 200, 204, 201 ],
	[ 207, 204, 207, 204, 204, 206, 204, 204, 204, 204, 204, 204, 204, 202, 204, 201 ],
	[ 207, 204, 207, 204, 204, 207, 204, 204, 204, 204, 204, 204, 202, 204, 204, 202 ],
	[ 207, 204, 207, 204, 204, 207, 204, 204, 204, 204, 204, 202, 204, 204, 202, 201 ],
	[ 207, 204, 207, 204, 204, 207, 204, 204, 204, 204, 202, 204, 204, 201, 204, 201 ],
	[ 207, 204, 207, 204, 204, 208, 204, 204, 205, 202, 204, 204, 204, 202, 204, 201 ],
	[ 207, 204, 207, 204, 204, 204, 208, 202, 204, 204, 204, 204, 202, 204, 204, 202 ],
	[ 207, 204, 208, 204, 204, 204, 204, 204, 204, 204, 205, 202, 204, 204, 202, 7 ],
	[ 207, 204, 204, 208, 205, 205, 205, 205, 205, 202, 204, 204, 205, 202, 4, 8 ],
	[ 207, 204, 204, 204, 204, 204, 204, 204, 204, 204, 205, 202, 4, 51, 51, 4 ],
	[ 208, 205, 205, 205, 205, 205, 205, 205, 205, 202, 4, 4, 4, 4, 4, 4 ]
],
"objects": [
	{
		"class": "io.github.pokemeetup.system.gameplay.overworld.World$WorldObjectData",
		"x": -62528,
		"y": -12928,
		"type": "SNOW_TREE"
	}
],
"blocks": [],
"lastModified": 0,
"isMultiplayer": false
}