{
"x": -128,
"y": -27,
"biomeType": "SNOW",
"tileData": [
	[ 206, 203, 203, 203, 203, 203, 206, 203, 203, 200, 203, 203, 203, 200, 203, 200 ],
	[ 207, 204, 204, 204, 204, 235, 204, 204, 204, 204, 203, 200, 204, 204, 200, 201 ],
	[ 207, 204, 204, 204, 201, 204, 207, 204, 204, 204, 204, 204, 200, 204, 201, 201 ],
	[ 206, 203, 203, 203, 200, 204, 207, 204, 204, 204, 204, 204, 202, 204, 201, 201 ],
	[ 207, 204, 204, 204, 204, 203, 204, 204, 204, 204, 204, 202, 204, 204, 202, 201 ],
	[ 207, 204, 204, 204, 204, 204, 204, 204, 204, 204, 202, 204, 204, 202, 204, 201 ],
	[ 207, 204, 204, 204, 204, 204, 204, 205, 205, 202, 204, 204, 202, 204, 204, 201 ],
	[ 207, 204, 204, 204, 204, 204, 201, 204, 235, 204, 204, 202, 204, 204, 205, 202 ],
	[ 208, 204, 204, 204, 204, 204, 202, 203, 204, 205, 202, 204, 204, 202, 5, 1 ],
	[ 207, 208, 205, 205, 205, 202, 204, 204, 202, 204, 204, 204, 202, 5, 7, 8 ],
	[ 207, 204, 204, 204, 204, 204, 204, 202, 204, 204, 205, 202, 5, 7, 5, 5 ],
	[ 208, 205, 204, 204, 204, 204, 202, 204, 204, 201, 4, 4, 9, 5, 8, 7 ],
	[ 208, 204, 208, 205, 205, 202, 204, 204, 204, 202, 4, 5, 5, 7, 5, 1 ],
	[ 6, 208, 235, 204, 204, 204, 204, 204, 201, 4, 4, 5, 5, 5, 5, 5 ],
	[ 4, 4, 51, 208, 205, 205, 205, 205, 202, 4, 4, 5, 9, 7, 5, 5 ],
	[ 4, 4, 51, 4, 4, 4, 4, 6, 4, 6, 5, 7, 7, 5, 5, 7 ]
],
"objects": [
	{
		"class": "io.github.pokemeetup.system.gameplay.overworld.World$WorldObjectData",
		"x": -65120,
		"y": -13824,
		"type": "SNOW_TREE"
	},
	{
		"class": "io.github.pokemeetup.system.gameplay.overworld.World$WorldObjectData",
		"x": -65280,
		"y": -13344,
		"type": "POKEBALL"
	}
],
"blocks": [],
"lastModified": 0,
"isMultiplayer": false
}