{
"x": -121,
"y": -15,
"biomeType": "SNOW",
"tileData": [
	[ 6, 4, 4, 4, 4, 206, 203, 203, 203, 201, 203, 203, 203, 203, 203, 200 ],
	[ 4, 4, 4, 4, 206, 204, 204, 206, 203, 204, 203, 200, 204, 204, 204, 201 ],
	[ 4, 4, 4, 206, 204, 204, 206, 204, 204, 204, 204, 204, 203, 203, 200, 201 ],
	[ 4, 4, 51, 207, 204, 206, 204, 204, 204, 204, 204, 204, 204, 204, 204, 200 ],
	[ 4, 4, 206, 204, 204, 207, 204, 204, 206, 203, 200, 204, 204, 204, 204, 201 ],
	[ 4, 52, 207, 204, 206, 204, 204, 206, 204, 204, 204, 200, 204, 204, 204, 201 ],
	[ 4, 206, 204, 204, 207, 204, 206, 204, 204, 204, 204, 204, 200, 204, 204, 202 ],
	[ 4, 207, 204, 206, 204, 204, 207, 204, 204, 204, 204, 204, 202, 204, 201, 201 ],
	[ 206, 204, 204, 207, 204, 206, 204, 204, 204, 204, 204, 201, 204, 204, 201, 201 ],
	[ 207, 204, 206, 204, 204, 207, 204, 204, 204, 204, 204, 202, 204, 204, 202, 201 ],
	[ 208, 204, 208, 204, 204, 207, 204, 204, 204, 204, 202, 204, 204, 201, 204, 201 ],
	[ 1, 207, 204, 207, 204, 208, 204, 204, 205, 202, 204, 204, 204, 202, 204, 201 ],
	[ 22, 208, 204, 208, 204, 204, 208, 202, 204, 204, 204, 204, 202, 204, 204, 201 ],
	[ 1, 10, 208, 204, 208, 205, 204, 204, 204, 204, 204, 202, 204, 204, 204, 201 ],
	[ 10, 24, 10, 208, 204, 204, 208, 205, 205, 205, 202, 204, 204, 204, 204, 202 ],
	[ 1, 1, 1, 10, 208, 205, 205, 205, 205, 205, 205, 205, 205, 205, 202, 4 ]
],
"objects": [
	{
		"class": "io.github.pokemeetup.system.gameplay.overworld.World$WorldObjectData",
		"x": -61888,
		"y": -7648,
		"type": "SNOW_TREE"
	},
	{
		"class": "io.github.pokemeetup.system.gameplay.overworld.World$WorldObjectData",
		"x": -61792,
		"y": -7680,
		"type": "SNOW_TREE"
	},
	{
		"class": "io.github.pokemeetup.system.gameplay.overworld.World$WorldObjectData",
		"x": -61952,
		"y": -7552,
		"type": "SNOW_TREE"
	},
	{
		"class": "io.github.pokemeetup.system.gameplay.overworld.World$WorldObjectData",
		"x": -61536,
		"y": -7680,
		"type": "POKEBALL"
	}
],
"blocks": [],
"lastModified": 0,
"isMultiplayer": false
}