{
"x": -122,
"y": -50,
"biomeType": "SNOW",
"tileData": [
	[ 9, 5, 7, 10, 5, 5, 5, 7, 5, 8, 5, 4, 4, 51, 6, 4 ],
	[ 5, 5, 7, 206, 203, 203, 203, 203, 200, 7, 4, 4, 6, 4, 51, 4 ],
	[ 206, 203, 235, 204, 204, 204, 204, 204, 204, 200, 4, 51, 51, 4, 4, 4 ],
	[ 207, 204, 206, 203, 203, 203, 203, 200, 204, 204, 203, 203, 203, 200, 51, 51 ],
	[ 206, 203, 204, 204, 204, 204, 204, 204, 200, 204, 204, 204, 204, 204, 200, 4 ],
	[ 207, 204, 204, 204, 206, 200, 204, 204, 204, 203, 203, 203, 203, 200, 204, 200 ],
	[ 207, 204, 204, 206, 204, 204, 200, 204, 204, 204, 204, 204, 204, 204, 200, 201 ],
	[ 207, 204, 204, 208, 204, 204, 205, 203, 203, 203, 203, 203, 200, 204, 204, 200 ],
	[ 208, 204, 204, 204, 208, 202, 204, 207, 204, 204, 204, 204, 204, 200, 204, 201 ],
	[ 207, 207, 204, 204, 235, 204, 204, 207, 204, 204, 204, 204, 204, 201, 204, 201 ],
	[ 207, 208, 204, 204, 204, 203, 206, 204, 204, 204, 204, 204, 204, 202, 204, 201 ],
	[ 207, 204, 208, 204, 204, 204, 207, 204, 204, 204, 204, 204, 201, 204, 204, 202 ],
	[ 207, 204, 204, 208, 204, 204, 208, 204, 204, 204, 204, 204, 202, 204, 202, 201 ],
	[ 208, 205, 204, 204, 207, 204, 204, 208, 204, 204, 205, 202, 204, 202, 204, 201 ],
	[ 4, 4, 208, 204, 208, 204, 204, 204, 208, 202, 204, 204, 202, 204, 204, 201 ],
	[ 4, 4, 51, 208, 205, 208, 205, 205, 205, 205, 205, 202, 205, 205, 205, 202 ]
],
"objects": [
	{
		"class": "io.github.pokemeetup.system.gameplay.overworld.World$WorldObjectData",
		"x": -62464,
		"y": -25472,
		"type": "HAUNTED_TREE"
	},
	{
		"class": "io.github.pokemeetup.system.gameplay.overworld.World$WorldObjectData",
		"x": -62464,
		"y": -25568,
		"type": "HAUNTED_TREE"
	},
	{
		"class": "io.github.pokemeetup.system.gameplay.overworld.World$WorldObjectData",
		"x": -62464,
		"y": -25344,
		"type": "HAUNTED_TREE"
	}
],
"blocks": [],
"lastModified": 0,
"isMultiplayer": false
}