{
"x": -122,
"y": -54,
"biomeType": "SNOW",
"tileData": [
	[ 206, 203, 203, 206, 203, 203, 203, 203, 203, 203, 200, 203, 200, 4, 4, 6 ],
	[ 207, 204, 206, 204, 204, 204, 204, 204, 204, 204, 201, 204, 204, 203, 203, 200 ],
	[ 207, 204, 207, 204, 204, 204, 204, 204, 204, 204, 201, 204, 204, 204, 204, 201 ],
	[ 207, 206, 204, 204, 204, 204, 204, 204, 204, 204, 201, 204, 204, 204, 204, 201 ],
	[ 207, 207, 204, 204, 204, 204, 204, 204, 204, 204, 204, 200, 204, 204, 204, 201 ],
	[ 207, 207, 204, 204, 204, 204, 204, 204, 204, 204, 204, 201, 204, 204, 204, 202 ],
	[ 207, 208, 204, 204, 204, 204, 204, 204, 204, 204, 204, 201, 204, 204, 201, 4 ],
	[ 207, 204, 208, 204, 204, 204, 204, 204, 204, 204, 204, 202, 204, 204, 202, 4 ],
	[ 208, 204, 204, 208, 204, 204, 204, 204, 204, 204, 202, 204, 204, 201, 4, 52 ],
	[ 5, 208, 204, 204, 208, 205, 205, 205, 205, 202, 204, 204, 204, 202, 4, 4 ],
	[ 5, 7, 208, 204, 204, 204, 204, 204, 204, 204, 205, 205, 202, 5, 4, 6 ],
	[ 7, 7, 5, 208, 204, 204, 204, 205, 205, 202, 7, 7, 5, 5, 7, 5 ],
	[ 8, 7, 7, 7, 208, 205, 202, 5, 7, 5, 7, 5, 5, 7, 8, 5 ],
	[ 5, 8, 5, 5, 5, 7, 5, 5, 5, 7, 5, 5, 7, 8, 235, 204 ],
	[ 10, 5, 5, 5, 5, 7, 5, 5, 5, 5, 5, 1, 7, 5, 206, 201 ],
	[ 1, 8, 5, 7, 5, 8, 7, 1, 5, 5, 9, 5, 7, 5, 208, 202 ]
],
"objects": [
	{
		"class": "io.github.pokemeetup.system.gameplay.overworld.World$WorldObjectData",
		"x": -62272,
		"y": -27168,
		"type": "SNOW_TREE"
	},
	{
		"class": "io.github.pokemeetup.system.gameplay.overworld.World$WorldObjectData",
		"x": -62016,
		"y": -27296,
		"type": "POKEBALL"
	}
],
"blocks": [],
"lastModified": 0,
"isMultiplayer": false
}