{
"x": -99,
"y": -13,
"biomeType": "DESERT",
"tileData": [
	[ 11, 1, 11, 11, 1, 15, 16, 15, 2, 15, 15, 15, 15, 15, 15, 15 ],
	[ 12, 11, 12, 15, 15, 15, 15, 17, 15, 15, 15, 15, 17, 15, 17, 15 ],
	[ 12, 12, 15, 15, 17, 15, 15, 15, 15, 2, 15, 15, 15, 15, 15, 15 ],
	[ 11, 15, 15, 15, 15, 15, 15, 15, 15, 15, 15, 17, 2, 15, 15, 15 ],
	[ 15, 15, 15, 16, 2, 15, 15, 15, 2, 15, 15, 15, 15, 2, 15, 15 ],
	[ 15, 2, 17, 15, 15, 2, 15, 15, 2, 15, 2, 15, 2, 15, 15, 15 ],
	[ 15, 16, 17, 15, 2, 17, 15, 15, 15, 15, 15, 15, 15, 15, 15, 15 ],
	[ 15, 17, 15, 15, 2, 15, 2, 2, 15, 15, 2, 15, 17, 2, 15, 2 ],
	[ 15, 15, 15, 15, 15, 15, 15, 15, 15, 15, 15, 2, 15, 15, 17, 15 ],
	[ 15, 15, 16, 15, 15, 15, 15, 15, 15, 2, 15, 15, 16, 17, 15, 15 ],
	[ 15, 15, 15, 15, 15, 15, 15, 15, 15, 15, 15, 15, 15, 15, 15, 15 ],
	[ 15, 15, 16, 15, 15, 15, 15, 15, 15, 15, 15, 15, 15, 15, 16, 15 ],
	[ 15, 16, 15, 15, 15, 15, 15, 15, 2, 17, 15, 15, 15, 15, 15, 2 ],
	[ 15, 15, 15, 15, 15, 15, 15, 15, 15, 15, 15, 15, 15, 15, 15, 17 ],
	[ 16, 15, 15, 15, 15, 15, 15, 17, 17, 15, 15, 17, 17, 15, 15, 15 ],
	[ 17, 15, 15, 16, 16, 15, 15, 15, 15, 2, 15, 15, 15, 15, 17, 15 ]
],
"objects": [
	{
		"class": "io.github.pokemeetup.system.gameplay.overworld.World$WorldObjectData",
		"x": -50624,
		"y": -6624,
		"type": "TREE_0"
	},
	{
		"class": "io.github.pokemeetup.system.gameplay.overworld.World$WorldObjectData",
		"x": -50688,
		"y": -6528,
		"type": "TREE_0"
	},
	{
		"class": "io.github.pokemeetup.system.gameplay.overworld.World$WorldObjectData",
		"x": -50560,
		"y": -6528,
		"type": "POKEBALL"
	}
],
"blocks": [],
"lastModified": 0,
"isMultiplayer": false
}