{
"x": -122,
"y": -51,
"biomeType": "HAUNTED",
"tileData": [
	[ 4, 52, 7, 5, 5, 10, 5, 9, 5, 5, 7, 5, 5, 7, 5, 5 ],
	[ 4, 5, 5, 5, 5, 5, 5, 7, 5, 5, 5, 5, 5, 5, 5, 5 ],
	[ 7, 5, 5, 5, 8, 7, 5, 1, 5, 5, 7, 5, 5, 7, 5, 5 ],
	[ 5, 5, 5, 5, 5, 5, 5, 5, 5, 8, 9, 7, 8, 7, 5, 5 ],
	[ 5, 8, 7, 7, 5, 5, 7, 7, 8, 7, 7, 7, 7, 5, 5, 7 ],
	[ 5, 5, 5, 5, 5, 5, 7, 5, 7, 5, 8, 5, 5, 5, 5, 5 ],
	[ 5, 5, 7, 7, 5, 7, 5, 7, 7, 5, 7, 5, 5, 8, 9, 7 ],
	[ 5, 5, 5, 5, 7, 5, 1, 1, 1, 7, 5, 5, 7, 5, 7, 7 ],
	[ 7, 5, 5, 5, 7, 5, 7, 8, 5, 5, 5, 1, 5, 7, 5, 5 ],
	[ 1, 5, 5, 5, 5, 5, 5, 5, 5, 5, 8, 5, 5, 7, 5, 5 ],
	[ 9, 5, 5, 5, 5, 7, 5, 5, 5, 5, 5, 7, 8, 5, 7, 5 ],
	[ 7, 7, 5, 7, 5, 5, 5, 5, 5, 5, 5, 8, 5, 5, 5, 8 ],
	[ 5, 8, 7, 5, 7, 7, 7, 5, 7, 7, 5, 7, 7, 5, 8, 7 ],
	[ 7, 5, 5, 7, 5, 5, 7, 5, 5, 7, 7, 5, 5, 8, 9, 7 ],
	[ 5, 7, 7, 5, 5, 5, 5, 7, 5, 7, 5, 5, 9, 5, 5, 51 ],
	[ 5, 7, 5, 5, 7, 8, 5, 5, 7, 7, 5, 7, 5, 9, 51, 4 ]
],
"objects": [
	{
		"class": "io.github.pokemeetup.system.gameplay.overworld.World$WorldObjectData",
		"x": -62240,
		"y": -25920,
		"type": "POKEBALL"
	}
],
"blocks": [],
"lastModified": 0,
"isMultiplayer": false
}