{
"x": -126,
"y": -25,
"biomeType": "SNOW",
"tileData": [
	[ 4, 4, 51, 4, 51, 4, 206, 203, 203, 203, 203, 203, 203, 203, 203, 200 ],
	[ 4, 51, 4, 51, 4, 206, 204, 204, 204, 204, 204, 204, 204, 204, 204, 201 ],
	[ 52, 4, 4, 4, 4, 207, 204, 204, 204, 204, 206, 203, 203, 200, 204, 201 ],
	[ 4, 4, 4, 206, 203, 204, 204, 204, 206, 203, 204, 204, 204, 204, 200, 201 ],
	[ 51, 206, 203, 204, 204, 204, 204, 206, 204, 204, 204, 204, 204, 204, 201, 201 ],
	[ 206, 204, 204, 204, 206, 200, 204, 207, 204, 204, 204, 204, 204, 204, 201, 201 ],
	[ 207, 204, 206, 203, 204, 204, 203, 204, 204, 204, 204, 204, 204, 204, 201, 201 ],
	[ 206, 203, 204, 204, 204, 204, 204, 204, 204, 204, 204, 204, 204, 204, 202, 201 ],
	[ 207, 204, 204, 206, 203, 203, 200, 204, 204, 204, 204, 204, 204, 202, 204, 201 ],
	[ 207, 204, 206, 204, 204, 204, 204, 200, 204, 204, 204, 204, 202, 204, 204, 202 ],
	[ 207, 204, 208, 204, 204, 204, 204, 201, 204, 204, 204, 202, 204, 204, 202, 1 ],
	[ 207, 204, 204, 208, 204, 204, 204, 202, 204, 204, 202, 204, 204, 202, 24, 10 ],
	[ 207, 204, 204, 204, 208, 205, 202, 204, 204, 202, 204, 204, 202, 1, 1, 1 ],
	[ 208, 205, 205, 204, 204, 204, 204, 205, 202, 204, 205, 202, 24, 24, 1, 1 ],
	[ 207, 204, 204, 208, 204, 205, 202, 204, 204, 202, 1, 10, 10, 1, 1, 1 ],
	[ 208, 205, 205, 205, 201, 205, 205, 205, 202, 10, 10, 10, 1, 1, 1, 10 ]
],
"objects": [
	{
		"class": "io.github.pokemeetup.system.gameplay.overworld.World$WorldObjectData",
		"x": -64448,
		"y": -12768,
		"type": "SNOW_TREE"
	},
	{
		"class": "io.github.pokemeetup.system.gameplay.overworld.World$WorldObjectData",
		"x": -64512,
		"y": -12672,
		"type": "SNOW_TREE"
	},
	{
		"class": "io.github.pokemeetup.system.gameplay.overworld.World$WorldObjectData",
		"x": -64192,
		"y": -12320,
		"type": "POKEBALL"
	}
],
"blocks": [],
"lastModified": 0,
"isMultiplayer": false
}