{
"x": -126,
"y": -26,
"biomeType": "SNOW",
"tileData": [
	[ 8, 206, 203, 203, 200, 4, 6, 4, 4, 4, 6, 4, 4, 4, 4, 4 ],
	[ 206, 204, 206, 200, 204, 235, 203, 203, 200, 4, 51, 4, 4, 4, 4, 4 ],
	[ 207, 206, 204, 204, 203, 200, 204, 204, 204, 200, 4, 206, 200, 4, 4, 52 ],
	[ 207, 207, 204, 204, 204, 204, 200, 204, 204, 204, 203, 204, 204, 203, 200, 4 ],
	[ 206, 204, 204, 206, 203, 200, 204, 200, 204, 204, 204, 204, 204, 204, 204, 200 ],
	[ 207, 204, 206, 204, 204, 204, 200, 204, 203, 203, 203, 203, 203, 200, 204, 201 ],
	[ 207, 204, 207, 204, 204, 204, 201, 204, 204, 204, 204, 204, 204, 204, 203, 200 ],
	[ 207, 204, 208, 204, 204, 204, 204, 200, 204, 204, 206, 203, 203, 200, 204, 201 ],
	[ 207, 204, 204, 207, 204, 204, 204, 204, 203, 203, 204, 204, 204, 204, 200, 201 ],
	[ 207, 204, 204, 208, 204, 204, 204, 204, 204, 204, 204, 204, 204, 204, 201, 201 ],
	[ 207, 204, 204, 204, 208, 205, 205, 204, 204, 204, 204, 204, 204, 204, 201, 201 ],
	[ 207, 204, 204, 204, 204, 204, 204, 208, 204, 204, 204, 204, 204, 204, 202, 201 ],
	[ 208, 204, 204, 204, 204, 204, 204, 204, 208, 204, 204, 204, 204, 202, 204, 201 ],
	[ 207, 208, 205, 205, 205, 204, 204, 204, 204, 208, 205, 205, 202, 204, 204, 202 ],
	[ 208, 235, 204, 204, 204, 208, 204, 204, 204, 204, 204, 204, 204, 204, 202, 201 ],
	[ 5, 5, 208, 205, 205, 205, 208, 205, 205, 205, 205, 205, 205, 202, 205, 202 ]
],
"objects": [
	{
		"class": "io.github.pokemeetup.system.gameplay.overworld.World$WorldObjectData",
		"x": -64512,
		"y": -13312,
		"type": "HAUNTED_TREE"
	},
	{
		"class": "io.github.pokemeetup.system.gameplay.overworld.World$WorldObjectData",
		"x": -64032,
		"y": -13312,
		"type": "DEAD_TREE"
	}
],
"blocks": [],
"lastModified": 0,
"isMultiplayer": false
}