{
"x": -97,
"y": -14,
"biomeType": "FOREST",
"tileData": [
	[ 56, 54, 56, 55, 12, 1, 11, 11, 11, 12, 17, 15, 15, 15, 15, 15 ],
	[ 53, 12, 56, 12, 11, 11, 11, 11, 11, 1, 2, 15, 15, 15, 15, 15 ],
	[ 55, 56, 11, 11, 11, 11, 11, 1, 12, 11, 15, 15, 15, 15, 2, 16 ],
	[ 12, 55, 11, 11, 11, 12, 11, 1, 11, 11, 15, 15, 15, 15, 2, 15 ],
	[ 56, 56, 12, 11, 11, 11, 12, 12, 12, 1, 15, 15, 15, 15, 15, 15 ],
	[ 56, 12, 12, 11, 11, 11, 11, 11, 12, 15, 15, 2, 2, 15, 15, 2 ],
	[ 11, 11, 12, 11, 1, 11, 11, 12, 11, 1, 15, 17, 15, 15, 15, 15 ],
	[ 11, 1, 11, 11, 1, 12, 12, 11, 1, 1, 16, 15, 15, 2, 15, 2 ],
	[ 11, 11, 11, 11, 11, 11, 11, 10, 1, 1, 1, 15, 15, 15, 15, 2 ],
	[ 12, 11, 11, 12, 11, 11, 12, 10, 1, 15, 10, 15, 15, 15, 2, 15 ],
	[ 11, 12, 12, 1, 11, 1, 1, 12, 11, 15, 17, 15, 2, 16, 15, 2 ],
	[ 1, 12, 10, 11, 20, 11, 11, 11, 12, 1, 1, 15, 17, 15, 2, 16 ],
	[ 11, 12, 11, 11, 12, 11, 11, 12, 11, 11, 15, 2, 15, 15, 2, 2 ],
	[ 11, 11, 1, 11, 11, 11, 11, 11, 10, 11, 17, 16, 15, 15, 15, 15 ],
	[ 11, 11, 12, 11, 11, 1, 11, 11, 12, 11, 15, 15, 2, 2, 15, 15 ],
	[ 11, 11, 11, 11, 12, 11, 11, 11, 1, 1, 1, 15, 15, 15, 17, 15 ]
],
"objects": [
	{
		"class": "io.github.pokemeetup.system.gameplay.overworld.World$WorldObjectData",
		"x": -49600,
		"y": -7136,
		"type": "RUINS_TREE"
	},
	{
		"class": "io.github.pokemeetup.system.gameplay.overworld.World$WorldObjectData",
		"x": -49504,
		"y": -7168,
		"type": "RUINS_TREE"
	},
	{
		"class": "io.github.pokemeetup.system.gameplay.overworld.World$WorldObjectData",
		"x": -49344,
		"y": -6784,
		"type": "POKEBALL"
	}
],
"blocks": [],
"lastModified": 0,
"isMultiplayer": false
}