{
"x": -128,
"y": -24,
"biomeType": "PLAINS",
"tileData": [
	[ 4, 4, 10, 1, 24, 1, 10, 206, 203, 203, 203, 200, 1, 10, 1, 1 ],
	[ 6, 4, 1, 1, 10, 10, 206, 204, 204, 204, 204, 204, 203, 200, 1, 10 ],
	[ 4, 6, 1, 1, 206, 203, 204, 204, 204, 204, 204, 204, 204, 204, 200, 1 ],
	[ 51, 4, 10, 24, 207, 204, 204, 204, 204, 204, 204, 204, 204, 204, 204, 200 ],
	[ 6, 4, 1, 1, 207, 204, 204, 204, 204, 204, 204, 204, 204, 204, 204, 201 ],
	[ 4, 51, 10, 206, 204, 204, 204, 204, 204, 204, 204, 204, 204, 204, 204, 201 ],
	[ 4, 4, 1, 207, 204, 204, 204, 204, 204, 204, 204, 204, 204, 204, 204, 201 ],
	[ 4, 4, 1, 207, 204, 204, 204, 204, 204, 204, 204, 204, 204, 204, 204, 201 ],
	[ 4, 52, 24, 207, 204, 204, 204, 204, 204, 204, 204, 204, 204, 204, 204, 201 ],
	[ 51, 51, 1, 208, 204, 204, 204, 204, 204, 204, 204, 204, 204, 204, 204, 201 ],
	[ 6, 201, 1, 10, 208, 205, 204, 204, 204, 204, 204, 204, 204, 204, 205, 202 ],
	[ 4, 1, 10, 1, 1, 1, 208, 205, 205, 205, 205, 205, 205, 202, 24, 1 ],
	[ 4, 10, 10, 1, 1, 1, 1, 1, 1, 1, 1, 10, 1, 24, 10, 10 ],
	[ 4, 1, 1, 10, 24, 1, 10, 24, 24, 10, 1, 1, 1, 1, 24, 1 ],
	[ 4, 1, 10, 24, 10, 10, 24, 1, 1, 1, 1, 1, 24, 10, 10, 1 ],
	[ 52, 10, 1, 1, 10, 1, 24, 207, 203, 203, 203, 203, 201, 1, 1, 1 ]
],
"objects": [
	{
		"class": "io.github.pokemeetup.system.gameplay.overworld.World$WorldObjectData",
		"x": -65472,
		"y": -12256,
		"type": "SNOW_TREE"
	},
	{
		"class": "io.github.pokemeetup.system.gameplay.overworld.World$WorldObjectData",
		"x": -65376,
		"y": -12288,
		"type": "SNOW_TREE"
	},
	{
		"class": "io.github.pokemeetup.system.gameplay.overworld.World$WorldObjectData",
		"x": -65120,
		"y": -12288,
		"type": "SNOW_TREE"
	},
	{
		"class": "io.github.pokemeetup.system.gameplay.overworld.World$WorldObjectData",
		"x": -65120,
		"y": -11968,
		"type": "POKEBALL"
	}
],
"blocks": [],
"lastModified": 0,
"isMultiplayer": false
}