{
"x": -121,
"y": -13,
"biomeType": "SNOW",
"tileData": [
	[ 4, 4, 4, 4, 4, 4, 4, 4, 4, 51, 4, 4, 4, 4, 4, 4 ],
	[ 4, 6, 4, 6, 4, 206, 203, 203, 200, 4, 4, 52, 4, 4, 4, 51 ],
	[ 6, 4, 4, 4, 206, 204, 204, 204, 204, 235, 203, 200, 4, 4, 4, 6 ],
	[ 4, 6, 4, 206, 204, 204, 206, 203, 203, 200, 204, 204, 200, 4, 6, 4 ],
	[ 6, 4, 206, 204, 204, 206, 204, 204, 204, 204, 200, 204, 204, 200, 6, 4 ],
	[ 4, 4, 207, 204, 206, 204, 204, 204, 204, 204, 204, 200, 204, 201, 4, 4 ],
	[ 4, 206, 204, 206, 204, 204, 206, 203, 203, 200, 204, 204, 200, 235, 4, 4 ],
	[ 4, 207, 204, 207, 204, 206, 204, 204, 204, 204, 200, 204, 201, 204, 200, 6 ],
	[ 4, 207, 204, 207, 204, 207, 204, 204, 204, 204, 201, 204, 201, 204, 201, 4 ],
	[ 4, 207, 204, 207, 204, 208, 204, 204, 204, 204, 201, 204, 201, 204, 201, 4 ],
	[ 4, 208, 204, 207, 204, 204, 208, 204, 204, 204, 201, 204, 201, 204, 201, 4 ],
	[ 51, 52, 207, 208, 204, 204, 204, 208, 204, 204, 202, 204, 201, 204, 204, 200 ],
	[ 4, 4, 207, 204, 208, 204, 204, 204, 208, 202, 204, 204, 201, 204, 204, 201 ],
	[ 4, 4, 208, 204, 204, 208, 205, 204, 204, 204, 204, 204, 201, 204, 204, 202 ],
	[ 4, 6, 51, 208, 205, 204, 204, 208, 205, 204, 204, 204, 201, 204, 201, 6 ],
	[ 6, 51, 51, 4, 52, 208, 205, 205, 205, 208, 205, 205, 202, 205, 202, 4 ]
],
"objects": [
	{
		"class": "io.github.pokemeetup.system.gameplay.overworld.World$WorldObjectData",
		"x": -61568,
		"y": -6624,
		"type": "SNOW_TREE"
	},
	{
		"class": "io.github.pokemeetup.system.gameplay.overworld.World$WorldObjectData",
		"x": -61952,
		"y": -6304,
		"type": "SNOW_TREE"
	},
	{
		"class": "io.github.pokemeetup.system.gameplay.overworld.World$WorldObjectData",
		"x": -61888,
		"y": -6624,
		"type": "SNOW_TREE"
	},
	{
		"class": "io.github.pokemeetup.system.gameplay.overworld.World$WorldObjectData",
		"x": -61792,
		"y": -6656,
		"type": "SNOW_TREE"
	},
	{
		"class": "io.github.pokemeetup.system.gameplay.overworld.World$WorldObjectData",
		"x": -61760,
		"y": -6176,
		"type": "SNOW_TREE"
	}
],
"blocks": [],
"lastModified": 0,
"isMultiplayer": false
}