{
"x": -83,
"y": -19,
"biomeType": "SNOW",
"tileData": [
	[ 5, 7, 4, 4, 4, 4, 51, 6, 4, 4, 4, 4, 4, 4, 4, 4 ],
	[ 1, 5, 4, 4, 4, 4, 4, 6, 4, 4, 4, 4, 4, 6, 4, 4 ],
	[ 5, 5, 6, 4, 4, 4, 4, 4, 4, 6, 4, 4, 51, 4, 4, 51 ],
	[ 5, 7, 4, 4, 4, 4, 4, 4, 52, 6, 4, 4, 4, 4, 4, 4 ],
	[ 7, 4, 6, 4, 4, 4, 4, 4, 6, 4, 4, 4, 6, 4, 4, 6 ],
	[ 5, 6, 51, 4, 4, 4, 51, 6, 4, 4, 4, 4, 52, 6, 4, 6 ],
	[ 5, 4, 51, 4, 4, 51, 4, 4, 6, 4, 4, 4, 6, 4, 4, 6 ],
	[ 7, 4, 4, 4, 4, 4, 4, 51, 4, 6, 4, 6, 51, 51, 4, 4 ],
	[ 7, 4, 4, 6, 4, 4, 4, 4, 4, 4, 4, 4, 4, 6, 4, 4 ],
	[ 4, 4, 4, 4, 4, 6, 4, 4, 6, 6, 4, 4, 4, 52, 4, 4 ],
	[ 6, 51, 4, 4, 4, 51, 4, 4, 4, 4, 4, 6, 4, 4, 4, 6 ],
	[ 4, 4, 4, 4, 4, 4, 4, 51, 4, 4, 51, 4, 4, 4, 51, 4 ],
	[ 4, 51, 51, 4, 4, 52, 51, 4, 4, 4, 51, 4, 4, 4, 4, 4 ],
	[ 4, 4, 4, 4, 4, 51, 6, 6, 6, 4, 6, 4, 6, 4, 51, 51 ],
	[ 4, 52, 4, 4, 4, 4, 4, 6, 4, 4, 4, 4, 6, 51, 4, 4 ],
	[ 51, 4, 4, 4, 4, 4, 51, 6, 6, 4, 4, 51, 4, 51, 4, 4 ]
],
"objects": [
	{
		"class": "io.github.pokemeetup.system.gameplay.overworld.World$WorldObjectData",
		"x": -42432,
		"y": -9696,
		"type": "HAUNTED_TREE"
	},
	{
		"class": "io.github.pokemeetup.system.gameplay.overworld.World$WorldObjectData",
		"x": -42336,
		"y": -9728,
		"type": "HAUNTED_TREE"
	},
	{
		"class": "io.github.pokemeetup.system.gameplay.overworld.World$WorldObjectData",
		"x": -42240,
		"y": -9728,
		"type": "DEAD_TREE"
	}
],
"blocks": [],
"lastModified": 0,
"isMultiplayer": false
}