{
"x": -128,
"y": -26,
"biomeType": "SNOW",
"tileData": [
	[ 206, 203, 203, 206, 200, 203, 203, 203, 203, 203, 203, 200, 4, 4, 4, 4 ],
	[ 206, 203, 203, 204, 204, 200, 204, 204, 204, 204, 204, 204, 200, 52, 6, 4 ],
	[ 207, 204, 204, 204, 204, 204, 203, 203, 203, 203, 200, 204, 204, 200, 4, 4 ],
	[ 207, 204, 204, 206, 200, 204, 204, 204, 204, 204, 204, 200, 204, 201, 6, 4 ],
	[ 207, 204, 206, 204, 204, 200, 204, 204, 204, 204, 204, 201, 204, 204, 200, 4 ],
	[ 207, 206, 204, 204, 204, 201, 204, 204, 204, 204, 204, 201, 204, 204, 201, 4 ],
	[ 207, 208, 204, 204, 204, 202, 204, 204, 204, 204, 204, 201, 204, 204, 202, 4 ],
	[ 207, 204, 208, 205, 202, 204, 204, 204, 204, 204, 204, 202, 204, 202, 4, 4 ],
	[ 207, 204, 204, 204, 204, 204, 204, 204, 204, 204, 202, 204, 201, 4, 4, 51 ],
	[ 208, 204, 204, 204, 204, 204, 205, 205, 205, 202, 204, 204, 202, 51, 4, 4 ],
	[ 207, 208, 204, 204, 204, 202, 204, 204, 204, 204, 204, 202, 6, 4, 4, 4 ],
	[ 207, 204, 208, 205, 202, 204, 204, 204, 204, 205, 202, 51, 4, 4, 51, 4 ],
	[ 208, 205, 204, 204, 204, 204, 204, 204, 202, 51, 51, 4, 4, 4, 4, 51 ],
	[ 5, 7, 208, 205, 205, 205, 205, 202, 4, 4, 4, 51, 4, 51, 4, 4 ],
	[ 7, 5, 5, 1, 5, 5, 7, 5, 51, 4, 4, 4, 4, 4, 4, 4 ],
	[ 9, 5, 5, 7, 7, 5, 9, 9, 51, 51, 4, 4, 6, 4, 4, 4 ]
],
"objects": [
	{
		"class": "io.github.pokemeetup.system.gameplay.overworld.World$WorldObjectData",
		"x": -65120,
		"y": -13312,
		"type": "HAUNTED_TREE"
	},
	{
		"class": "io.github.pokemeetup.system.gameplay.overworld.World$WorldObjectData",
		"x": -65056,
		"y": -13088,
		"type": "HAUNTED_TREE"
	},
	{
		"class": "io.github.pokemeetup.system.gameplay.overworld.World$WorldObjectData",
		"x": -65056,
		"y": -13216,
		"type": "HAUNTED_TREE"
	},
	{
		"class": "io.github.pokemeetup.system.gameplay.overworld.World$WorldObjectData",
		"x": -65056,
		"y": -13312,
		"type": "DEAD_TREE"
	}
],
"blocks": [],
"lastModified": 0,
"isMultiplayer": false
}