{
"x": -123,
"y": -49,
"biomeType": "SNOW",
"tileData": [
	[ 9, 5, 5, 1, 9, 7, 5, 4, 4, 6, 4, 4, 6, 4, 4, 4 ],
	[ 5, 5, 5, 5, 5, 7, 4, 4, 4, 6, 51, 4, 4, 52, 4, 4 ],
	[ 5, 7, 5, 5, 5, 5, 4, 4, 51, 4, 4, 6, 4, 4, 4, 4 ],
	[ 5, 5, 206, 200, 235, 4, 6, 4, 4, 4, 4, 4, 4, 4, 4, 4 ],
	[ 5, 206, 204, 204, 203, 203, 203, 200, 4, 4, 52, 4, 4, 51, 4, 4 ],
	[ 206, 204, 204, 206, 203, 203, 200, 204, 235, 200, 4, 4, 6, 4, 4, 4 ],
	[ 207, 204, 206, 204, 204, 204, 204, 203, 200, 204, 200, 52, 4, 4, 4, 4 ],
	[ 207, 206, 204, 204, 204, 204, 204, 204, 204, 200, 201, 4, 6, 4, 4, 4 ],
	[ 206, 204, 204, 204, 204, 204, 204, 204, 204, 201, 204, 200, 6, 4, 4, 4 ],
	[ 207, 204, 204, 204, 204, 204, 204, 204, 204, 204, 200, 235, 4, 4, 4, 6 ],
	[ 207, 204, 204, 204, 204, 204, 204, 204, 204, 204, 202, 201, 4, 4, 6, 4 ],
	[ 208, 205, 205, 205, 205, 204, 204, 204, 204, 202, 204, 202, 4, 51, 4, 51 ],
	[ 207, 204, 204, 204, 204, 208, 205, 205, 202, 204, 201, 4, 51, 6, 4, 6 ],
	[ 208, 204, 204, 204, 204, 204, 204, 204, 204, 204, 202, 51, 6, 4, 4, 4 ],
	[ 4, 208, 205, 204, 204, 204, 204, 204, 204, 201, 6, 4, 4, 4, 4, 52 ],
	[ 4, 4, 4, 208, 205, 205, 205, 205, 205, 202, 4, 4, 4, 4, 4, 4 ]
],
"objects": [
	{
		"class": "io.github.pokemeetup.system.gameplay.overworld.World$WorldObjectData",
		"x": -62912,
		"y": -25056,
		"type": "HAUNTED_TREE"
	},
	{
		"class": "io.github.pokemeetup.system.gameplay.overworld.World$WorldObjectData",
		"x": -62976,
		"y": -24960,
		"type": "HAUNTED_TREE"
	},
	{
		"class": "io.github.pokemeetup.system.gameplay.overworld.World$WorldObjectData",
		"x": -62912,
		"y": -24960,
		"type": "SMALL_HAUNTED_TREE"
	},
	{
		"class": "io.github.pokemeetup.system.gameplay.overworld.World$WorldObjectData",
		"x": -62848,
		"y": -25088,
		"type": "SMALL_HAUNTED_TREE"
	}
],
"blocks": [],
"lastModified": 0,
"isMultiplayer": false
}