{
"x": -120,
"y": -11,
"biomeType": "SNOW",
"tileData": [
	[ 4, 4, 206, 203, 203, 203, 203, 203, 206, 203, 200, 203, 200, 51, 4, 4 ],
	[ 4, 4, 207, 204, 204, 204, 204, 206, 204, 204, 204, 200, 204, 200, 4, 4 ],
	[ 4, 206, 204, 204, 204, 204, 206, 204, 204, 204, 204, 204, 200, 204, 200, 4 ],
	[ 206, 204, 204, 204, 204, 206, 204, 204, 206, 203, 200, 204, 204, 200, 204, 200 ],
	[ 207, 204, 204, 204, 206, 204, 204, 206, 204, 204, 204, 200, 204, 201, 204, 201 ],
	[ 207, 204, 204, 204, 207, 204, 204, 207, 204, 204, 204, 204, 200, 204, 200, 201 ],
	[ 207, 204, 204, 204, 207, 204, 206, 204, 204, 204, 204, 204, 201, 204, 201, 201 ],
	[ 207, 204, 204, 204, 207, 204, 208, 204, 204, 204, 204, 204, 201, 204, 201, 201 ],
	[ 208, 204, 204, 204, 207, 204, 204, 208, 204, 204, 204, 204, 202, 204, 201, 201 ],
	[ 10, 208, 204, 204, 208, 204, 204, 204, 208, 204, 204, 202, 204, 204, 201, 201 ],
	[ 1, 10, 208, 204, 204, 208, 204, 204, 204, 208, 202, 204, 204, 204, 201, 201 ],
	[ 24, 1, 1, 207, 204, 204, 207, 204, 204, 204, 204, 204, 204, 204, 202, 201 ],
	[ 10, 1, 10, 208, 204, 204, 208, 204, 204, 204, 204, 204, 204, 202, 204, 201 ],
	[ 1, 1, 1, 10, 207, 204, 204, 208, 204, 204, 204, 205, 202, 204, 204, 202 ],
	[ 1, 10, 1, 1, 208, 204, 204, 204, 208, 205, 202, 204, 204, 204, 202, 10 ],
	[ 1, 1, 1, 10, 1, 208, 205, 205, 205, 205, 205, 205, 205, 202, 24, 24 ]
],
"objects": [
	{
		"class": "io.github.pokemeetup.system.gameplay.overworld.World$WorldObjectData",
		"x": -61024,
		"y": -5632,
		"type": "POKEBALL"
	}
],
"blocks": [],
"lastModified": 0,
"isMultiplayer": false
}