{
"x": -124,
"y": -52,
"biomeType": "SNOW",
"tileData": [
	[ 4, 4, 4, 4, 4, 4, 4, 4, 6, 4, 4, 4, 4, 4, 4, 51 ],
	[ 51, 4, 4, 4, 6, 4, 51, 4, 4, 4, 4, 4, 4, 4, 4, 4 ],
	[ 4, 51, 4, 51, 4, 4, 4, 4, 4, 206, 203, 203, 200, 6, 4, 4 ],
	[ 4, 206, 203, 203, 203, 203, 203, 203, 203, 204, 204, 204, 204, 203, 203, 200 ],
	[ 206, 204, 204, 204, 204, 204, 204, 204, 204, 206, 200, 204, 204, 204, 204, 201 ],
	[ 207, 204, 204, 206, 203, 203, 203, 203, 203, 204, 204, 200, 204, 204, 204, 201 ],
	[ 207, 204, 206, 204, 204, 204, 204, 204, 205, 204, 204, 204, 200, 204, 204, 201 ],
	[ 207, 204, 207, 204, 204, 206, 203, 200, 204, 207, 204, 204, 204, 200, 204, 201 ],
	[ 207, 204, 207, 204, 206, 204, 204, 204, 200, 204, 204, 204, 204, 202, 204, 201 ],
	[ 207, 204, 207, 204, 208, 204, 204, 204, 204, 200, 204, 204, 201, 204, 204, 201 ],
	[ 207, 204, 207, 204, 204, 208, 204, 204, 204, 202, 204, 204, 202, 204, 204, 201 ],
	[ 207, 204, 207, 204, 204, 204, 208, 205, 202, 204, 204, 201, 204, 204, 204, 202 ],
	[ 207, 204, 208, 204, 204, 204, 204, 204, 204, 204, 204, 202, 204, 204, 202, 4 ],
	[ 207, 204, 204, 208, 204, 204, 204, 204, 204, 205, 202, 204, 204, 202, 4, 51 ],
	[ 208, 204, 204, 204, 208, 205, 205, 205, 202, 204, 204, 204, 201, 6, 51, 6 ],
	[ 4, 208, 205, 205, 205, 205, 205, 205, 205, 205, 205, 205, 202, 4, 51, 4 ]
],
"objects": [
	{
		"class": "io.github.pokemeetup.system.gameplay.overworld.World$WorldObjectData",
		"x": -63488,
		"y": -26272,
		"type": "SNOW_TREE"
	},
	{
		"class": "io.github.pokemeetup.system.gameplay.overworld.World$WorldObjectData",
		"x": -63424,
		"y": -26592,
		"type": "SNOW_TREE"
	},
	{
		"class": "io.github.pokemeetup.system.gameplay.overworld.World$WorldObjectData",
		"x": -63072,
		"y": -26144,
		"type": "SNOW_TREE"
	},
	{
		"class": "io.github.pokemeetup.system.gameplay.overworld.World$WorldObjectData",
		"x": -63488,
		"y": -26496,
		"type": "SNOW_TREE"
	}
],
"blocks": [],
"lastModified": 0,
"isMultiplayer": false
}