{
"x": -127,
"y": -31,
"biomeType": "SNOW",
"tileData": [
	[ 4, 4, 4, 206, 203, 203, 203, 203, 203, 203, 203, 203, 203, 200, 4, 4 ],
	[ 4, 6, 206, 204, 204, 204, 204, 204, 204, 204, 204, 204, 204, 204, 203, 200 ],
	[ 4, 4, 207, 204, 204, 206, 203, 203, 203, 203, 200, 204, 204, 204, 204, 201 ],
	[ 4, 206, 204, 204, 206, 204, 204, 204, 204, 204, 204, 200, 204, 204, 204, 201 ],
	[ 4, 207, 204, 204, 207, 204, 204, 204, 204, 204, 204, 201, 204, 204, 204, 201 ],
	[ 52, 207, 204, 204, 207, 204, 204, 204, 204, 204, 204, 204, 200, 204, 204, 201 ],
	[ 4, 207, 204, 204, 207, 204, 206, 203, 200, 235, 204, 204, 201, 204, 204, 201 ],
	[ 4, 207, 204, 204, 207, 204, 208, 204, 201, 204, 207, 204, 204, 200, 204, 201 ],
	[ 4, 207, 204, 204, 207, 201, 204, 207, 204, 203, 200, 204, 204, 204, 200, 201 ],
	[ 4, 207, 204, 204, 207, 204, 206, 204, 204, 204, 204, 203, 200, 204, 204, 200 ],
	[ 51, 207, 204, 206, 204, 204, 207, 204, 204, 204, 204, 204, 204, 200, 204, 201 ],
	[ 4, 207, 204, 207, 204, 204, 207, 204, 204, 204, 204, 204, 204, 204, 200, 201 ],
	[ 6, 207, 204, 208, 204, 204, 208, 204, 204, 204, 204, 204, 204, 204, 202, 201 ],
	[ 4, 207, 204, 204, 208, 204, 204, 208, 204, 204, 204, 204, 204, 202, 204, 201 ],
	[ 4, 208, 204, 204, 204, 208, 204, 204, 208, 204, 205, 205, 202, 204, 204, 202 ],
	[ 4, 51, 208, 205, 205, 205, 208, 205, 205, 201, 205, 205, 205, 205, 202, 202 ]
],
"objects": [
	{
		"class": "io.github.pokemeetup.system.gameplay.overworld.World$WorldObjectData",
		"x": -64960,
		"y": -15840,
		"type": "SNOW_TREE"
	},
	{
		"class": "io.github.pokemeetup.system.gameplay.overworld.World$WorldObjectData",
		"x": -64608,
		"y": -15872,
		"type": "SNOW_TREE"
	}
],
"blocks": [],
"lastModified": 0,
"isMultiplayer": false
}