{
"x": -125,
"y": -26,
"biomeType": "SNOW",
"tileData": [
	[ 5, 7, 206, 203, 203, 206, 203, 203, 203, 203, 200, 203, 203, 200, 4, 4 ],
	[ 1, 235, 204, 204, 206, 204, 204, 204, 204, 204, 204, 200, 204, 201, 51, 51 ],
	[ 8, 206, 204, 204, 207, 204, 204, 204, 204, 204, 204, 201, 204, 204, 200, 4 ],
	[ 7, 207, 204, 204, 207, 204, 204, 204, 206, 200, 204, 204, 200, 204, 204, 200 ],
	[ 5, 207, 204, 204, 207, 204, 204, 206, 204, 204, 200, 204, 204, 200, 204, 201 ],
	[ 7, 207, 204, 204, 207, 204, 206, 204, 204, 204, 204, 200, 204, 204, 200, 201 ],
	[ 206, 204, 204, 206, 204, 204, 207, 204, 204, 204, 204, 204, 200, 204, 204, 200 ],
	[ 207, 204, 204, 207, 204, 204, 207, 204, 204, 204, 204, 204, 204, 200, 204, 201 ],
	[ 208, 204, 204, 207, 204, 204, 208, 204, 204, 204, 204, 204, 204, 201, 204, 201 ],
	[ 4, 208, 204, 208, 204, 204, 204, 208, 204, 204, 204, 204, 204, 202, 204, 201 ],
	[ 4, 51, 208, 204, 208, 204, 204, 204, 208, 204, 204, 204, 202, 204, 204, 202 ],
	[ 4, 4, 5, 208, 204, 208, 204, 204, 204, 208, 205, 202, 204, 204, 201, 201 ],
	[ 4, 4, 4, 5, 208, 204, 208, 204, 204, 204, 204, 204, 204, 204, 202, 201 ],
	[ 4, 4, 4, 5, 7, 207, 204, 208, 205, 205, 205, 205, 205, 202, 204, 201 ],
	[ 4, 4, 51, 5, 5, 208, 204, 204, 204, 204, 204, 204, 204, 204, 204, 202 ],
	[ 4, 6, 4, 51, 5, 5, 208, 205, 205, 205, 205, 205, 205, 205, 202, 4 ]
],
"objects": [
	{
		"class": "io.github.pokemeetup.system.gameplay.overworld.World$WorldObjectData",
		"x": -63840,
		"y": -13312,
		"type": "HAUNTED_TREE"
	},
	{
		"class": "io.github.pokemeetup.system.gameplay.overworld.World$WorldObjectData",
		"x": -64000,
		"y": -13280,
		"type": "HAUNTED_TREE"
	},
	{
		"class": "io.github.pokemeetup.system.gameplay.overworld.World$WorldObjectData",
		"x": -63584,
		"y": -13184,
		"type": "HAUNTED_TREE"
	},
	{
		"class": "io.github.pokemeetup.system.gameplay.overworld.World$WorldObjectData",
		"x": -63520,
		"y": -13152,
		"type": "DEAD_TREE"
	},
	{
		"class": "io.github.pokemeetup.system.gameplay.overworld.World$WorldObjectData",
		"x": -63936,
		"y": -13312,
		"type": "VINES"
	}
],
"blocks": [],
"lastModified": 0,
"isMultiplayer": false
}