{
"x": -124,
"y": -30,
"biomeType": "HAUNTED",
"tileData": [
	[ 4, 4, 4, 4, 4, 52, 4, 4, 51, 6, 6, 4, 52, 51, 4, 4 ],
	[ 51, 6, 4, 4, 4, 4, 206, 203, 203, 203, 203, 200, 4, 51, 4, 4 ],
	[ 5, 1, 9, 5, 7, 206, 204, 204, 204, 204, 204, 201, 4, 51, 4, 4 ],
	[ 5, 9, 5, 5, 206, 204, 204, 204, 204, 204, 204, 204, 200, 5, 5, 4 ],
	[ 10, 5, 5, 206, 204, 204, 204, 204, 204, 204, 204, 204, 204, 200, 235, 7 ],
	[ 5, 5, 5, 207, 204, 204, 204, 204, 204, 204, 204, 204, 204, 201, 5, 5 ],
	[ 5, 7, 5, 207, 204, 204, 204, 204, 204, 204, 204, 204, 204, 201, 7, 9 ],
	[ 5, 5, 5, 207, 204, 204, 204, 204, 204, 204, 204, 204, 204, 202, 7, 1 ],
	[ 7, 5, 5, 208, 205, 204, 204, 204, 205, 205, 205, 205, 202, 5, 7, 5 ],
	[ 7, 5, 5, 235, 5, 208, 205, 202, 235, 9, 5, 5, 5, 7, 5, 8 ],
	[ 5, 5, 5, 5, 7, 5, 7, 8, 7, 5, 5, 5, 7, 5, 8, 1 ],
	[ 5, 5, 5, 9, 7, 5, 5, 5, 5, 5, 5, 9, 5, 7, 7, 5 ],
	[ 5, 5, 5, 7, 5, 5, 5, 5, 5, 7, 5, 5, 9, 7, 7, 5 ],
	[ 5, 10, 9, 5, 7, 1, 5, 5, 10, 7, 5, 5, 5, 5, 5, 10 ],
	[ 1, 7, 5, 5, 5, 5, 5, 5, 7, 7, 9, 7, 5, 5, 5, 8 ],
	[ 7, 7, 7, 5, 5, 5, 10, 5, 7, 5, 7, 5, 9, 5, 5, 7 ]
],
"objects": [
	{
		"class": "io.github.pokemeetup.system.gameplay.overworld.World$WorldObjectData",
		"x": -63488,
		"y": -15008,
		"type": "SNOW_TREE"
	},
	{
		"class": "io.github.pokemeetup.system.gameplay.overworld.World$WorldObjectData",
		"x": -63488,
		"y": -15232,
		"type": "SNOW_TREE"
	},
	{
		"class": "io.github.pokemeetup.system.gameplay.overworld.World$WorldObjectData",
		"x": -63264,
		"y": -14880,
		"type": "POKEBALL"
	}
],
"blocks": [],
"lastModified": 0,
"isMultiplayer": false
}