{
"x": -123,
"y": -25,
"biomeType": "SNOW",
"tileData": [
	[ 5, 4, 206, 203, 206, 203, 203, 203, 203, 203, 203, 203, 203, 200, 203, 200 ],
	[ 5, 206, 204, 204, 207, 204, 204, 206, 203, 203, 200, 204, 204, 204, 200, 201 ],
	[ 206, 204, 204, 206, 204, 204, 206, 204, 204, 204, 204, 200, 204, 204, 204, 200 ],
	[ 207, 204, 204, 207, 204, 204, 207, 204, 204, 204, 204, 204, 200, 204, 204, 201 ],
	[ 207, 204, 206, 204, 204, 204, 207, 204, 204, 204, 204, 204, 202, 204, 204, 201 ],
	[ 207, 204, 207, 204, 204, 204, 207, 204, 204, 204, 204, 202, 204, 204, 204, 202 ],
	[ 207, 204, 208, 204, 204, 204, 207, 204, 204, 204, 201, 204, 207, 204, 201, 201 ],
	[ 208, 204, 204, 207, 204, 206, 204, 204, 204, 204, 204, 200, 204, 204, 201, 201 ],
	[ 7, 207, 204, 207, 204, 207, 204, 204, 204, 204, 204, 201, 204, 204, 201, 201 ],
	[ 9, 207, 204, 207, 204, 207, 204, 204, 204, 204, 204, 202, 204, 204, 202, 201 ],
	[ 5, 207, 204, 207, 204, 208, 204, 204, 204, 204, 202, 204, 204, 202, 204, 201 ],
	[ 7, 207, 204, 207, 204, 204, 208, 205, 205, 202, 204, 204, 201, 204, 204, 201 ],
	[ 5, 208, 204, 207, 204, 204, 204, 204, 204, 204, 204, 204, 202, 204, 204, 201 ],
	[ 5, 5, 235, 204, 204, 204, 204, 204, 204, 204, 205, 202, 204, 204, 204, 201 ],
	[ 5, 5, 207, 204, 208, 205, 205, 205, 205, 202, 204, 204, 204, 204, 204, 201 ],
	[ 5, 9, 208, 205, 205, 205, 205, 205, 205, 205, 205, 205, 205, 205, 205, 202 ]
],
"objects": [
	{
		"class": "io.github.pokemeetup.system.gameplay.overworld.World$WorldObjectData",
		"x": -62560,
		"y": -12800,
		"type": "HAUNTED_TREE"
	},
	{
		"class": "io.github.pokemeetup.system.gameplay.overworld.World$WorldObjectData",
		"x": -62656,
		"y": -12800,
		"type": "HAUNTED_TREE"
	},
	{
		"class": "io.github.pokemeetup.system.gameplay.overworld.World$WorldObjectData",
		"x": -62976,
		"y": -12800,
		"type": "HAUNTED_TREE"
	},
	{
		"class": "io.github.pokemeetup.system.gameplay.overworld.World$WorldObjectData",
		"x": -62496,
		"y": -12800,
		"type": "DEAD_TREE"
	}
],
"blocks": [],
"lastModified": 0,
"isMultiplayer": false
}