{
"x": -122,
"y": -53,
"biomeType": "SNOW",
"tileData": [
	[ 4, 4, 6, 4, 6, 6, 4, 4, 51, 51, 6, 4, 4, 4, 4, 4 ],
	[ 206, 203, 203, 203, 203, 200, 4, 4, 4, 4, 4, 4, 4, 4, 4, 6 ],
	[ 207, 204, 204, 204, 204, 204, 235, 203, 203, 200, 4, 4, 4, 4, 4, 4 ],
	[ 206, 203, 203, 203, 203, 203, 200, 204, 204, 204, 200, 4, 6, 51, 4, 6 ],
	[ 207, 204, 204, 204, 204, 204, 204, 203, 200, 204, 204, 200, 6, 4, 4, 4 ],
	[ 207, 204, 204, 204, 206, 203, 200, 204, 204, 200, 204, 204, 200, 4, 6, 4 ],
	[ 207, 204, 204, 206, 204, 204, 204, 200, 204, 204, 200, 204, 204, 200, 4, 6 ],
	[ 207, 204, 206, 204, 204, 204, 204, 204, 200, 204, 204, 200, 204, 201, 4, 4 ],
	[ 207, 204, 207, 204, 204, 204, 204, 204, 201, 204, 204, 202, 204, 201, 4, 6 ],
	[ 207, 204, 207, 204, 204, 204, 204, 204, 201, 204, 201, 204, 204, 202, 51, 4 ],
	[ 207, 204, 208, 204, 204, 204, 204, 204, 202, 204, 201, 204, 201, 4, 4, 4 ],
	[ 207, 204, 204, 208, 205, 205, 205, 202, 204, 204, 201, 204, 202, 4, 51, 4 ],
	[ 207, 204, 204, 204, 204, 204, 204, 204, 204, 204, 202, 235, 6, 51, 4, 4 ],
	[ 207, 204, 204, 204, 204, 204, 204, 204, 204, 202, 204, 201, 5, 1, 7, 5 ],
	[ 208, 205, 205, 205, 205, 205, 205, 205, 202, 204, 204, 202, 5, 9, 5, 7 ],
	[ 208, 205, 205, 205, 205, 205, 205, 205, 205, 205, 202, 5, 5, 5, 5, 5 ]
],
"objects": [
	{
		"class": "io.github.pokemeetup.system.gameplay.overworld.World$WorldObjectData",
		"x": -62464,
		"y": -26784,
		"type": "SNOW_TREE"
	},
	{
		"class": "io.github.pokemeetup.system.gameplay.overworld.World$WorldObjectData",
		"x": -62112,
		"y": -26720,
		"type": "SNOW_TREE"
	},
	{
		"class": "io.github.pokemeetup.system.gameplay.overworld.World$WorldObjectData",
		"x": -62272,
		"y": -26656,
		"type": "SNOW_TREE"
	},
	{
		"class": "io.github.pokemeetup.system.gameplay.overworld.World$WorldObjectData",
		"x": -62464,
		"y": -27008,
		"type": "SNOW_TREE"
	}
],
"blocks": [],
"lastModified": 0,
"isMultiplayer": false
}