{
"x": -127,
"y": -30,
"biomeType": "SNOW",
"tileData": [
	[ 4, 51, 4, 4, 4, 4, 4, 206, 203, 203, 203, 203, 203, 203, 200, 4 ],
	[ 4, 6, 52, 4, 4, 206, 203, 204, 204, 206, 203, 203, 203, 200, 204, 200 ],
	[ 4, 4, 4, 206, 203, 204, 204, 206, 203, 204, 204, 204, 204, 204, 200, 201 ],
	[ 4, 4, 206, 204, 204, 204, 206, 204, 204, 206, 203, 200, 204, 204, 201, 201 ],
	[ 4, 4, 207, 204, 204, 206, 204, 204, 206, 204, 204, 204, 200, 204, 201, 201 ],
	[ 4, 4, 207, 204, 206, 204, 204, 206, 204, 204, 204, 204, 201, 204, 204, 201 ],
	[ 4, 206, 204, 204, 207, 235, 204, 204, 204, 204, 204, 204, 201, 204, 201, 201 ],
	[ 206, 204, 204, 206, 201, 204, 207, 204, 204, 204, 204, 204, 202, 204, 201, 201 ],
	[ 207, 204, 206, 204, 206, 203, 204, 204, 204, 204, 205, 202, 204, 204, 201, 201 ],
	[ 207, 206, 204, 206, 204, 204, 204, 204, 204, 202, 204, 204, 204, 204, 202, 201 ],
	[ 206, 204, 206, 204, 204, 204, 204, 204, 201, 204, 204, 204, 205, 202, 204, 201 ],
	[ 207, 206, 204, 204, 204, 204, 204, 204, 201, 204, 204, 201, 204, 204, 204, 201 ],
	[ 207, 208, 204, 204, 204, 204, 204, 204, 202, 204, 204, 202, 204, 204, 204, 202 ],
	[ 207, 204, 208, 205, 205, 205, 205, 202, 204, 204, 201, 204, 204, 204, 201, 6 ],
	[ 208, 204, 204, 204, 204, 204, 204, 204, 204, 204, 202, 204, 204, 204, 204, 200 ],
	[ 208, 208, 205, 205, 205, 205, 205, 205, 205, 202, 205, 205, 205, 205, 205, 202 ]
],
"objects": [
	{
		"class": "io.github.pokemeetup.system.gameplay.overworld.World$WorldObjectData",
		"x": -64960,
		"y": -15328,
		"type": "SNOW_TREE"
	},
	{
		"class": "io.github.pokemeetup.system.gameplay.overworld.World$WorldObjectData",
		"x": -64608,
		"y": -14880,
		"type": "SNOW_TREE"
	},
	{
		"class": "io.github.pokemeetup.system.gameplay.overworld.World$WorldObjectData",
		"x": -64864,
		"y": -15360,
		"type": "SNOW_TREE"
	},
	{
		"class": "io.github.pokemeetup.system.gameplay.overworld.World$WorldObjectData",
		"x": -65024,
		"y": -15232,
		"type": "SNOW_TREE"
	}
],
"blocks": [],
"lastModified": 0,
"isMultiplayer": false
}