{
"x": -124,
"y": -51,
"biomeType": "SNOW",
"tileData": [
	[ 4, 206, 203, 203, 203, 203, 203, 206, 203, 200, 200, 4, 4, 6, 4, 4 ],
	[ 206, 204, 204, 204, 204, 206, 203, 204, 204, 204, 200, 235, 4, 4, 4, 6 ],
	[ 207, 204, 204, 204, 206, 204, 204, 204, 204, 204, 201, 201, 4, 51, 6, 4 ],
	[ 207, 204, 204, 206, 204, 204, 204, 204, 204, 204, 201, 201, 4, 6, 4, 4 ],
	[ 207, 204, 206, 204, 204, 204, 204, 204, 204, 204, 201, 201, 51, 51, 4, 52 ],
	[ 207, 204, 208, 204, 204, 204, 204, 204, 204, 204, 202, 235, 4, 6, 4, 52 ],
	[ 207, 204, 204, 208, 204, 204, 204, 204, 204, 202, 204, 204, 203, 200, 4, 4 ],
	[ 207, 204, 204, 204, 208, 205, 205, 205, 201, 204, 204, 206, 200, 204, 200, 4 ],
	[ 208, 204, 204, 204, 204, 204, 204, 204, 207, 203, 203, 204, 204, 200, 204, 200 ],
	[ 51, 207, 204, 204, 204, 204, 204, 206, 204, 204, 204, 204, 204, 204, 200, 201 ],
	[ 4, 208, 204, 204, 204, 204, 206, 204, 204, 204, 206, 200, 204, 204, 204, 200 ],
	[ 52, 4, 207, 204, 204, 204, 207, 204, 204, 206, 204, 204, 200, 204, 204, 202 ],
	[ 51, 4, 208, 204, 204, 204, 207, 204, 204, 208, 204, 204, 202, 204, 201, 201 ],
	[ 4, 4, 4, 208, 204, 204, 208, 204, 201, 204, 208, 202, 235, 204, 202, 201 ],
	[ 4, 4, 4, 4, 208, 204, 204, 208, 202, 204, 204, 204, 204, 201, 204, 202 ],
	[ 4, 4, 4, 4, 4, 208, 205, 205, 205, 205, 205, 205, 205, 205, 202, 9 ]
],
"objects": [
	{
		"class": "io.github.pokemeetup.system.gameplay.overworld.World$WorldObjectData",
		"x": -63104,
		"y": -26080,
		"type": "SNOW_TREE"
	},
	{
		"class": "io.github.pokemeetup.system.gameplay.overworld.World$WorldObjectData",
		"x": -63488,
		"y": -25760,
		"type": "SNOW_TREE"
	},
	{
		"class": "io.github.pokemeetup.system.gameplay.overworld.World$WorldObjectData",
		"x": -63328,
		"y": -25728,
		"type": "SNOW_TREE"
	},
	{
		"class": "io.github.pokemeetup.system.gameplay.overworld.World$WorldObjectData",
		"x": -63296,
		"y": -25632,
		"type": "SNOW_TREE"
	}
],
"blocks": [],
"lastModified": 0,
"isMultiplayer": false
}