{
"x": -122,
"y": -47,
"biomeType": "PLAINS",
"tileData": [
	[ 4, 4, 10, 206, 203, 203, 200, 10, 1, 1, 1, 24, 1, 24, 1, 1 ],
	[ 4, 4, 206, 204, 204, 204, 204, 200, 1, 1, 1, 10, 1, 10, 1, 1 ],
	[ 4, 206, 204, 204, 204, 204, 204, 204, 200, 24, 10, 10, 24, 1, 1, 1 ],
	[ 206, 204, 204, 204, 204, 204, 204, 204, 201, 1, 10, 1, 1, 1, 10, 1 ],
	[ 207, 204, 204, 204, 204, 204, 204, 204, 204, 200, 10, 1, 1, 1, 1, 1 ],
	[ 207, 204, 204, 204, 204, 204, 204, 204, 204, 201, 1, 1, 1, 1, 24, 10 ],
	[ 207, 204, 204, 204, 204, 204, 204, 204, 204, 201, 1, 1, 1, 10, 10, 1 ],
	[ 207, 204, 204, 204, 204, 204, 204, 204, 204, 201, 1, 10, 10, 10, 22, 1 ],
	[ 207, 204, 204, 204, 204, 204, 204, 204, 204, 201, 1, 1, 1, 10, 10, 1 ],
	[ 207, 204, 204, 204, 204, 204, 204, 204, 204, 201, 1, 10, 10, 1, 1, 1 ],
	[ 207, 204, 204, 204, 204, 204, 204, 204, 205, 202, 22, 1, 10, 1, 1, 24 ],
	[ 208, 205, 205, 205, 205, 205, 205, 202, 11, 12, 11, 1, 1, 1, 1, 10 ],
	[ 12, 11, 12, 11, 11, 11, 12, 11, 20, 11, 11, 11, 1, 24, 1, 10 ],
	[ 12, 11, 11, 11, 11, 11, 11, 11, 11, 11, 11, 11, 10, 10, 1, 1 ],
	[ 12, 11, 11, 11, 12, 11, 11, 12, 11, 11, 12, 12, 11, 11, 12, 1 ],
	[ 11, 11, 12, 12, 11, 11, 11, 11, 11, 1, 11, 12, 12, 12, 11, 12 ]
],
"objects": [
	{
		"class": "io.github.pokemeetup.system.gameplay.overworld.World$WorldObjectData",
		"x": -62080,
		"y": -23680,
		"type": "POKEBALL"
	}
],
"blocks": [],
"lastModified": 0,
"isMultiplayer": false
}