{
"x": -122,
"y": -15,
"biomeType": "SNOW",
"tileData": [
	[ 51, 4, 4, 4, 206, 203, 203, 203, 203, 203, 206, 203, 200, 203, 203, 200 ],
	[ 6, 4, 206, 203, 204, 204, 204, 206, 203, 203, 204, 204, 201, 204, 204, 201 ],
	[ 206, 203, 204, 204, 204, 206, 203, 204, 204, 204, 204, 204, 201, 204, 204, 201 ],
	[ 207, 204, 204, 204, 206, 204, 204, 204, 204, 204, 204, 204, 204, 200, 204, 201 ],
	[ 207, 204, 204, 206, 204, 204, 204, 204, 204, 204, 204, 204, 204, 201, 204, 201 ],
	[ 208, 204, 204, 208, 204, 204, 204, 204, 204, 206, 200, 204, 204, 204, 200, 201 ],
	[ 4, 208, 204, 204, 207, 204, 204, 206, 203, 204, 204, 200, 204, 204, 201, 201 ],
	[ 4, 4, 207, 204, 207, 204, 206, 204, 204, 204, 204, 204, 200, 204, 201, 201 ],
	[ 4, 4, 207, 204, 207, 204, 207, 204, 204, 204, 204, 204, 202, 204, 201, 201 ],
	[ 4, 4, 207, 204, 207, 204, 208, 204, 204, 204, 204, 201, 204, 204, 201, 201 ],
	[ 4, 51, 207, 204, 208, 204, 204, 208, 204, 204, 204, 202, 204, 204, 202, 201 ],
	[ 4, 206, 204, 204, 204, 208, 204, 204, 208, 205, 202, 204, 204, 202, 204, 201 ],
	[ 206, 204, 204, 204, 204, 204, 208, 204, 204, 204, 204, 204, 202, 204, 204, 201 ],
	[ 207, 205, 205, 205, 204, 204, 204, 208, 205, 204, 204, 202, 204, 204, 204, 202 ],
	[ 201, 4, 4, 4, 208, 205, 204, 204, 204, 208, 202, 204, 204, 205, 202, 4 ],
	[ 4, 51, 51, 4, 51, 4, 208, 205, 205, 205, 205, 205, 202, 51, 4, 4 ]
],
"objects": [
	{
		"class": "io.github.pokemeetup.system.gameplay.overworld.World$WorldObjectData",
		"x": -62208,
		"y": -7648,
		"type": "SNOW_TREE"
	}
],
"blocks": [],
"lastModified": 0,
"isMultiplayer": false
}