{
"x": -80,
"y": -18,
"biomeType": "HAUNTED",
"tileData": [
	[ 4, 5, 5, 8, 5, 5, 7, 9, 5, 5, 5, 5, 7, 5, 5, 5 ],
	[ 5, 7, 7, 5, 7, 5, 9, 5, 7, 10, 5, 7, 7, 5, 5, 5 ],
	[ 5, 7, 5, 5, 7, 5, 5, 5, 1, 5, 7, 7, 9, 5, 5, 8 ],
	[ 7, 8, 9, 5, 7, 7, 5, 8, 5, 10, 7, 9, 5, 5, 8, 7 ],
	[ 5, 7, 7, 9, 5, 5, 7, 7, 9, 7, 5, 5, 9, 5, 5, 7 ],
	[ 5, 7, 9, 5, 7, 7, 5, 5, 8, 5, 5, 5, 9, 5, 5, 5 ],
	[ 5, 7, 5, 5, 5, 5, 5, 8, 7, 7, 5, 5, 8, 5, 1, 5 ],
	[ 7, 5, 5, 5, 7, 10, 5, 5, 5, 5, 5, 5, 7, 8, 5, 5 ],
	[ 5, 5, 5, 5, 5, 1, 5, 7, 9, 1, 5, 5, 7, 7, 5, 7 ],
	[ 7, 7, 7, 5, 5, 5, 5, 5, 7, 5, 8, 5, 7, 5, 5, 5 ],
	[ 5, 10, 9, 8, 5, 5, 9, 8, 7, 8, 8, 5, 5, 7, 7, 5 ],
	[ 9, 7, 5, 7, 5, 7, 7, 5, 7, 5, 5, 9, 7, 7, 7, 5 ],
	[ 10, 7, 7, 5, 9, 5, 5, 5, 8, 5, 5, 5, 7, 7, 5, 7 ],
	[ 5, 5, 5, 5, 9, 5, 5, 1, 5, 5, 5, 5, 5, 5, 1, 5 ],
	[ 9, 5, 7, 5, 5, 5, 1, 5, 5, 7, 7, 5, 5, 8, 5, 5 ],
	[ 5, 7, 7, 1, 7, 9, 5, 5, 7, 7, 7, 7, 5, 5, 5, 7 ]
],
"objects": [
	{
		"class": "io.github.pokemeetup.system.gameplay.overworld.World$WorldObjectData",
		"x": -40480,
		"y": -9120,
		"type": "POKEBALL"
	}
],
"blocks": [],
"lastModified": 0,
"isMultiplayer": false
}